ふと 私 の 覚え書き を 見る と 、 七 〇 も の 不思議 だ 事件 が ある	ふと私の覚え書きを見ると、七〇もの不思議な事件がある
この 八 年間 、 事件 を通じて 友人 シャーロック・ホームズ の 手際 を 考える て くる た	この八年間、事件を通じて友人シャーロック・ホームズの手際を考えてきた
その 中 に は 多く の 悲劇 と 少し の 喜劇 が ある 、 あと の 大半 は 単に 変わる た だけ の もの だ た が 、 普通 という もの は ひとつ として ない	その中には多くの悲劇と少しの喜劇があり、あとの大半は単に変わっただけのものだったが、普通というものはひとつとしてない
なぜなら 、 どちら か と いう と シャーロック・ホームズ は 好き だ から 仕事 を 受ける の だ ある 、 お金 を 得る ため で は ない	なぜなら、どちらかというとホームズは好きだから仕事を受けるのであり、お金を得るためではない
何 の 変哲 も ない 調査 は 、 かかわる たい ない と 一蹴 する て しまう	何の変哲もない調査は、かかわりたくないと一蹴してしまう
途方 も ない 事件 だ ない て は なる ない	途方もない事件でなくてはならない
その よう だ 様々 の 事件 の なか でも 、 これ ほど に 奇怪 きわまる もの は 他 に ない だ う	そのような様々の事件のなかでも、これほどに奇怪きわまるものは他にないだろう
サリィ州ストーク・モラン に 住む 、 かの 有名 だ グリムズビ・ロイロット 家 の 話 だ ある	サリィ州ストーク・モランに住む、かの有名なロイロット家の話である
くだん の 事件 は 、 シャーロック・ホームズ と 付き合う 始める て 間 も ない 頃 に 起こる 、 まだ 我々 は ベイ カー 街 で 下宿 を 共用 する て いる た	くだんの事件は、ホームズと付き合い始めて間もない頃に起こり、まだ我々はベイカー街で下宿を共用していた
もっと 早い に 公表 する て も よい た の かも しれる ない が 、 当時 は 口外 する ない 約束 を する て おる 、 こうして 私 が 自由 に なる た の は 、 ちょうど 先日 、 約束 を 交わす て いる た ご 婦人 が 、 時 なる ぬ 死 を 迎える た ため だ	もっと早くに公表してもよかったのかもしれないが、当時は口外しない約束をしており、こうして私が自由になったのは、ちょうど先日、約束を交わしていたご婦人が、時ならぬ死を迎えたためだ
私 に できる こと は おそらく 、 すべて の 事実 を 白日 の 下 に さらす こと だ ある	私にできることはおそらく、すべての事実を白日の下にさらすことである
それ に は 理由 が ある	それには理由がある
グリムズビ・ロイロット 博士 の 死 について 風聞 が 広がる て いる こと を 私 は 知る た	グリムズビ・ロイロット博士の死について風聞が広がっていることを私は知った
そして 、 その いずれ も が 真実 を おどろおどろしい ねじ曲げる て いる た から だ ある	そして、そのいずれもが真実をおどろおどろしくねじ曲げていたからである
八三年 の 四月初め 、 ある 朝 、 私 が 目 を 覚ます と 、 シャーロック・ホームズ が 身支度 を 調える 、 枕元 に 立つ て いる た	八三年の四月初め、ある朝、私が目を覚ますと、シャーロック・ホームズが身支度を調え、枕元に立っていた
普段 は 遅い まで 眠る て いる 男 だ のに 、 暖炉 の 上 の 置き時計 に よる ば 、 まだ 七時一五分 を 回る た ばかり	普段は遅くまで眠っている男なのに、暖炉の上の置き時計によれば、まだ七時一五分を回ったばかり
私 は 何ごと か と 目 を ぱちくり する せる ながら シャーロック・ホームズ の 方 を 向く	私は何ごとかと目をぱちくりさせながらホームズの方を向く
おそらく 少々 機嫌 も 悪い た	おそらく少々機嫌も悪かった
私 の 朝 は 、 決まる て こう だ の だ た	私の朝は、決まってこうなのだった
気の毒 だ が 起きる た まえる 、 ワトソン	気の毒だが起きたまえ、ワトソン
シャーロック・ホームズ の 声 だ	ホームズの声だ
今朝 は みな 同じ 具合 だ の だ	今朝はみな同じ具合なのだ
ハドソン さん が 戸 の 音 で たたき起こす れる 、 僕 の ところ へ やってくる	ハドソンさんが戸の音でたたき起こされ、僕のところへやってくる
そして 僕 は 君 の ところ へ	そして僕は君のところへ
何 か ね 、 まさか —— 火事 か	何かね、まさか——火事か
いや 、 依頼 人 だ	いや、依頼人だ
年 の 若い ご 婦人 が 興奮 気味 に 来る れる た らしい 、 僕 に 面会 する たい 、 と	年の若いご婦人が興奮気味に来られたらしく、僕に面会したい、と
居間 で 待つ て もらう て いる	居間で待ってもらっている
どう だ ね 、 若い ご 婦人 が こんな 朝 早い 都会 を ほっつく 歩く て 、 眠り込む で いる 他人 を たたき起こす と なる ば 、 よく よく 差し迫る た 事情 が ある と 考える ぬ ば なる ぬ	どうだね、若いご婦人がこんな朝早く都会をほっつき歩いて、眠り込んでいる他人をたたき起こすとなれば、よくよく差し迫った事情があると考えねばならぬ
万一 これ が 本当に 面白い 事件 だ と する ば 、 君 は きっと 、 はじめ から かかわる たい がる	万一これが本当に面白い事件だとすれば、君はきっと、はじめからかかわりたがる
いずれ に する 、 声 を かける だけ かける て 、 君 に 決める て もらう ぬ ば	いずれにせよ、声をかけるだけかけて、君に決めてもらわねば
心 の 友 よ 、 どんな 事件 も 逃す もの か	心の友よ、どんな事件も逃すものか
私 にとって 、 シャーロック・ホームズ の 調査 に 立ち会う こと ほど 、 深い 楽しみ を 感じる もの は ない た	私にとって、ホームズの調査に立ち会うことほど、深い楽しみを感じるものはなかった
あの 迅速 だ 推理 に 驚く の も よい	あの迅速な推理に驚くのもよい
早い すぎる て 当てずっぽう に も 思える が 、 その 実 いつも 論拠 が ある 、 結果 、 持ち込む れる た 問題 を 解き明かす て しまう	早すぎて当てずっぽうにも思えるが、その実いつも論拠があり、結果、持ち込まれた問題を解き明かしてしまう
私 は 大急ぎ で 服 を つける 、 それ から 二 、 三 分 の のち に は 我が 友 と 一緒 に 居間 へ 入る た	私は大急ぎで服をつけ、それから二、三分ののちには我が友と一緒に居間へ入った
と 、 黒い 服 に 身 を 包む 、 顔 に は 厚い 面 紗 を かける た 一 人 の 夫人 が 、 窓際 の 椅子 から 立ち上がる た	と、黒い服に身を包み、顔には厚い面紗をかけた一人の夫人が、窓際の椅子から立ち上がった
おはよう ござる ます	おはようございます
シャーロック・ホームズ は 朗らか に 挨拶 する た	ホームズは朗らかに挨拶した
僕 が シャーロック・ホームズ です	僕がシャーロック・ホームズです
こちら は 私 の 友人 で 助手 の ワトソン 博士	こちらは私の友人で助手のワトソン博士
僕 同様 に 、 何 を お話 に なる て も 結構 です	僕同様に、何をお話になっても結構です
おる と 、 ハドソン さん が 気 を 利く せる て 暖炉 に 火 を つける て くれる た よう です ね	おっと、ハドソンさんが気を利かせて暖炉に火をつけてくれたようですね
どうぞ 火 の 方 へ	どうぞ火の方へ
熱い コーヒー は いかが です か	熱いコーヒーはいかがですか
ふるえる て いらっしゃる	ふるえていらっしゃる
寒い て ふるえる て いる の だ は ござる ます ん	寒くてふるえているのではございません
と 女性 は 言う れる まま に 椅子 を 寄せる ながら 、 低い 声 で 言う た	と女性は言われるままに椅子を寄せながら、低い声で言った
ほう	ほう
すると	すると
こわい ん です 、 シャーロック・ホームズ さん	こわいんです、ホームズさん
おそろしい て	おそろしくて
と 言う て 、 依頼 人 は 面 紗 を あげる た が 、 なるほど 気の毒 だ ほど に 動揺 する きる て いる た	と言って、依頼人は面紗をあげたが、なるほど気の毒なほどに動揺しきっていた
顔 は やつれる て 血の気 が ない 、 目 は およぐ ばかり だ 、 狙う れる た 獲物 の よう だ	顔はやつれて血の気がなく、目はおよぐばかりで、狙われた獲物のようだ
顔つき や 体つき から 見る ば 、 まだ 三 十 そこそこ の 女性 だ と いう のに 、 頭 に は 早い も 白い もの が まじる 、 憔悴 が 顔 から 見る て とれる	顔つきや体つきから見れば、まだ三十そこそこの女性だというのに、頭には早くも白いものがまじり、憔悴が顔から見てとれる
シャーロック・ホームズ は 、 ひと目 依頼 人 に 目 を 向ける た だけ だ 、 すべて が わかる た よう だ た	シャーロック・ホームズは、ひと目依頼人に目を向けただけで、すべてがわかったようだった
ご 安心 を	ご安心を
シャーロック・ホームズ は やさしい 言葉 を かける て 身 を 乗り出す 、 依頼 人 の 腕 に 手 を 置く た	ホームズはやさしく言葉をかけて身を乗り出し、依頼人の腕に手を置いた
僕ら が すぐ 解決 する て 差し上げる ます 、 ですから	僕らがすぐ解決して差し上げます、ですから
今朝 の 汽車 で お 着く に なる た 、 の です ね	今朝の汽車でお着きになった、のですね
申す ます た かしら	申しましたかしら
いえ 、 ただ 左 の 手袋 の あいだ に 復路 の 切符 が 見える ます た ので	いえ、ただ左の手袋のあいだに復路の切符が見えましたので
朝 早い ご 出立 に なる 、 二 輪 馬車 に お 乗り に なる て 、 ぬかるむ だ 道 を 通る 、 駅 まで いらっしゃる た	朝早くご出立になり、二輪馬車にお乗りになって、ぬかるんだ道を通り、駅までいらっしゃった
依頼 人 は はる として 、 我が 友人 を 不思議 という 目 で 見つめる た	依頼人ははっとして、我が友人を不思議という目で見つめた
不思議 だ こと だ は ある ます ん	不思議なことではありません
と シャーロック・ホームズ は ほほえむ	とホームズはほほえむ
上着 の 左 袖 に 七つ も 泥 の 跳ね が ござる ます	上着の左袖に七つも泥の跳ねがございます
しかも まだ つく た ばかり の	しかもまだついたばかりの
そういう ところ へ 泥 を 揚げる 乗り物 と 言う ば 二 輪 馬車 だけ だ 、 なお 御者 の 左側 に 腰 を 下ろす た 場合 に 限る れる ます	そういうところへ泥を揚げる乗り物と言えば二輪馬車だけで、なお御者の左側に腰を下ろした場合に限られます
説明 は わかる ます ん が 、 おっしゃる 通り です	説明はわかりませんが、おっしゃる通りです
わたくし は 今朝 六 時 に 家 を 出る ます て 、 二 〇 分 に レザヘッド駅 へ 着く 、 それから ウォータルー 行き の 始発 に 乗る て まいる ます た	わたくしは今朝六時に家を出まして、二〇分にレザヘッド駅へ着き、それからウォータルー行きの始発に乗ってまいりました
わたくし は 、 わたくし は もう これ 以上 耐える られる ます ん	わたくしは、わたくしはもうこれ以上耐えられません
この まま で は おかしい なる そう です	このままではおかしくなりそうです
頼れる 人 が おる ます ん … … 誰 も	頼れる人がおりません……誰も
ただ ひとり 、 心配 する て くれる 者 も ある ます が 、 あいにく 、 力 に なれる ない の です	ただひとり、心配してくれる者もありますが、あいにく、力になれないのです
そこで シャーロック・ホームズ さん の こと を 思い出す て	そこでホームズさんのことを思い出して
ファリントッシュ さん から うかがう て 、 助ける て いただく た こと が ある と	ファリントッシュさんからうかがって、助けていただいたことがあると
この 住所 を 教える て いただく た ん です	この住所を教えていただいたんです
どうか わたくし を お 助ける くださる	どうかわたくしをお助けください
いえ 、 せめて 、 今 わたくし を 取り巻く て いる 深い 闇 に 、 少し の 光 を … …	いえ、せめて、今わたくしを取り巻いている深い闇に、少しの光を……
今 の わたくし で は お礼 も 十分 に は 致す かねる ます が 、 あと ひと月 ふた 月 の あいだ に 結婚 する て 、 お金 を 自由 に できる よう に なる ます ので 、 そう する ば 相応 の お礼 も できる か と 思う ます	今のわたくしではお礼も十分には致しかねますが、あとひと月ふた月のあいだに結婚して、お金を自由にできるようになりますので、そうすれば相応のお礼もできるかと思います
シャーロック・ホームズ は 自分 の 机 の ところ へ 行く 、 錠 を 外す て 、 取り出す た 小さな 事件 簿 を めくる た	ホームズは自分の机のところへ行き、錠を外して、取り出した小さな事件簿をめくった
ファリントッシュ … … そう か 、 思い出す た	ファリントッシュ……そうか、思い出した
オパール の 髪 飾り か	オパールの髪飾りか
知り合う 前 の 事件 だ 、 ワトソン	知り合う前の事件だ、ワトソン
断言 致す ます 、 この シャーロック・ホームズ 喜ぶ で 、 ご 友人 の とき と 同じく あなた に も 最大限 の 助力 を 致す ます	断言致します、このホームズ喜んで、ご友人のときと同じくあなたにも最大限の助力を致します
お礼 の こと です が 、 事件 そのもの が 既に 報酬 です	お礼のことですが、事件そのものが既に報酬です
支払う 金額 は お 任せる 致す ます し 、 都合 の よい とき で	支払う金額はお任せ致しますし、都合のよいときで
僕 が お願い する の は 、 すべて を お話 くださる 、 と だけ	僕がお願いするのは、すべてをお話ください、とだけ
どんな こと だ も 、 事件 を 考える の に 役立つ ます ので	どんなことでも、事件を考えるのに役立ちますので
ああ	ああ
と 依頼 人 が 話す 始める	と依頼人が話し始める
今 の わたくし にとって 最も 恐ろしい こと は 、 この 恐怖 が 何 の ため か わかる ない こと です て 、 まったく 些細 だ こと が 気 に なる の です	今のわたくしにとって最も恐ろしいことは、この恐怖が何のためかわからないことでして、まったく些細なことが気になるのです
他人 から 見る ば つまらない こと かも しれる ます ん	他人から見ればつまらないことかもしれません
本来 頼り に する べし あの 方 だ さえ 、 神経質 だ 女 の たわ言 だ と 考える くらい だ の です から	本来頼りにすべきあの方でさえ、神経質な女のたわ言だと考えるくらいなのですから
口 に は 出す ます ん が 、 なだめる たり 、 目 を そらす たり 、 わたくし に も わかる ます	口には出しませんが、なだめたり、目をそらしたり、わたくしにもわかります
しかし 、 シャーロック・ホームズ さん 、 あなた は 人間 の 心 に 潜む 悪意 だ 、 どんな もの だ も 見抜く れる とか	しかし、ホームズさん、あなたは人間の心に潜む悪意なら、どんなものでも見抜かれるとか
ですから 、 わたくし に 近づく 危険 を どう 避ける ば よい の か 教える て くださる と 思う て … …	ですから、わたくしに近づく危険をどう避ければよいのか教えてくださると思って……
傾聴 致す ます	傾聴致します
わたくし は 、 ヘレン・ストーナ と 申す ます	わたくしは、ヘレン・ストーナと申します
ただいま 義理 の 父親 の グリムズビ・ロイロット 博士 と 一緒 に 住む で おる ます	ただいま義理の父親のロイロット博士と一緒に住んでおります
グリムズビ・ロイロット 家 は 、 イングランド で も 古い サクソン の 家系 の 末裔 で 、 サリィ州 の 西 の 果て 、 ストーク・モラン に ござる ます	ロイロット家は、イングランドでも古いサクソンの家系の末裔で、サリィ州の西の果て、ストーク・モランにございます
シャーロック・ホームズ は うなずく た	ホームズはうなずいた
その 名 は 存じる て おる ます	その名は存じております
一時 は 、 一族 も 裕福 だ ある ます た	一時は、一族も裕福でありました
地所 は 、 北 は バークシア 、 西 は ハンプシア まで 広がる て おる ます た	地所は、北はバークシア、西はハンプシアまで広がっておりました
しかし 一八世紀 、 四 代 にわたり 当主 たち が 放埒 を する て 財産 を 使い果たす 、 結果 として 、 摂政 時代 に は 賭博 で 一族 は 身 を 崩す て しまう ます た	しかし一八世紀、四代にわたり当主たちが放埒をして財産を使い果たし、結果として、摂政時代には賭博で一族は身を崩してしまいました
ただ 数 エーカー の 土地 と 、 築 二〇〇年 に も なる 屋敷 だけ は 残る ます た が 、 それ も 抵当 に 入る て いる 始末 だ ござる ます	ただ数エーカーの土地と、築二〇〇年にもなる屋敷だけは残りましたが、それも抵当に入っている始末でございます
先代 は それでも 無為 だ 人生 を 送る 、 清貧 に 甘んじる た とか	先代はそれでも無為な人生を送り、清貧に甘んじたとか
けれども その ひとり 息子 、 つまり これ が 義理 の 父 だ の です が 、 そこ から 抜け出る う と 思う た らしい 、 親類 から 学資 を 立て替える て もらう 、 どうにか 医者 の 学位 を 取る ます た	けれどもそのひとり息子、つまりこれが義理の父なのですが、そこから抜け出ようと思ったらしく、親類から学資を立て替えてもらい、どうにか医者の学位を取りました
それから インド の カルカッタ へ 参る ます て 、 そこで 、 技術 と 持ち前 の 性格 も ある て か 、 医院 を 開業 致す ます た	それからインドのカルカッタへ参りまして、そこで、技術と持ち前の性格もあってか、医院を開業致しました
ある とき 、 家内 で 窃盗 事件 が 立て続け に 起こる ます て 、 かん しゃく を 起こす 、 現地 で 雇う た 執事 を 殴る 殺す て しまう た そう です	あるとき、家内で窃盗事件が立て続けに起こりまして、かんしゃくを起こし、現地で雇った執事を殴り殺してしまったそうです
死刑 は すんで の ところ で 免れる た よう です	死刑はすんでのところで免れたようです
もっとも 、 長い 禁固刑 に 苦しめる られる た せい か 、 その後 、 内地 へ 戻る て から は 、 すれる た 気むずかしい 人 に なる て しまう ます た	もっとも、長い禁固刑に苦しめられたせいか、その後、内地へ戻ってからは、すれた気むずかしい人になってしまいました
その グリムズビ・ロイロット 博士 と わたくし の 母 が 結婚 する た の は 、 インド に いる た 頃 で 、 当時 わたくし の 母 は 、 ベンガル砲 兵隊 に いる た ヘレン・ストーナ 少将 の 若い 未亡人 です た	そのロイロット博士とわたくしの母が結婚したのは、インドにいた頃で、当時わたくしの母は、ベンガル砲兵隊にいたストーナ少将の若き未亡人でした
わたくし と 、 姉 の ジュリア は 双子 で 、 再婚 する た とき は まだ 二 歳 の 赤ん坊 だ ござる ます た	わたくしと、姉のジュリアは双子で、再婚したときはまだ二歳の赤ん坊でございました
母 は かなり の 金持ち だ ござる ます て 、 一 年 に 一 〇 〇 〇 ポンド 以上 の 収入 が ござる ます た が 、 その 金 は そっくり グリムズビ・ロイロット 博士 に 遺言 で 譲る て しまう ます た	母はかなりの金持ちでございまして、一年に一〇〇〇ポンド以上の収入がございましたが、その金はそっくりロイロット博士に遺言で譲ってしまいました
もっとも それ は 、 わたくし ども 姉妹 が 、 継父 と 一緒 に 暮らす て いる あいだ の こと だけ だ 、 もし わたくし ども が 結婚 いたす ます と 、 それから 後 は わたくし ども に も 毎年 ある 決まる た 金額 の 金 を 分ける て くれる 決まり に なる て いる の だ ござる ます	もっともそれは、わたくしども姉妹が、継父と一緒に暮らしているあいだのことだけで、もしわたくしどもが結婚いたしますと、それから後はわたくしどもにも毎年ある決まった金額の金を分けてくれる決まりになっているのでございます
母 は 内地 に 帰る て まもなく 亡くなる ます た	母は内地に帰ってまもなく亡くなりました
八年前 、 クルー の 近く で 鉄道 事故 に 遭う た の です	八年前、クルーの近くで鉄道事故に遭ったのです
母 亡き後 の 父 は 、 ロンドン で 開業 する つもり だ ある た の を よす て 、 わたくし ども を 連れる 、 ストーク・モラン に ある 一族 代々 の 屋敷 へ 戻る て 住む こと に なる ます た	母亡き後の父は、ロンドンで開業するつもりであったのをよして、わたくしどもを連れ、ストーク・モランにある一族代々の屋敷へ戻って住むことになりました
母 の 遺産 が ある ます こと ゆえる 、 生活 に は 何 不自由 ない 、 よそ 様 が ご覧 に なる ば 、 わたくし ども は まことに 結構 だ 身分 の よう に 見える た こと だ ござる ます う	母の遺産がありますことゆえ、生活には何不自由なく、よそ様がご覧になれば、わたくしどもはまことに結構な身分のように見えたことでございましょう
ところが この 頃 から 、 にわかに 父 の 様子 が 変わる て まいる ます た	ところがこの頃から、にわかに父の様子が変わってまいりました
人 と 付き合う こと を 極端 に 嫌う ます て 、 ストーク・モラン の グリムズビ・ロイロット が 代々 の 地所 に 戻る て くる た と 村人 が 喜ぶ に も かかわる ぬ 、 家 の 中 に 閉じこもる て ばかり いる ます た	人と付き合うことを極端に嫌いまして、ストーク・モランのロイロットが代々の地所に戻ってきたと村人が喜ぶにもかかわらず、家の中に閉じこもってばかりいました
たまに 外出 いたす ます と 、 道 で 会う た 村人 と 相手 かまう ぬ の 喧嘩 を する の です	たまに外出いたしますと、道で会った村人と相手かまわずの喧嘩をするのです
もともと グリムズビ・ロイロット 家 の 者 は 気 の 荒い 血筋 を 引く て いる の です が 、 父 の 場合 は 、 その 血筋 の 上 に 熱帯 で の 長い 生活 が 重なる て 、 いっそう ひどい の だ ござる ます た	もともとロイロット家の者は気の荒い血筋を引いているのですが、父の場合は、その血筋の上に熱帯での長い生活が重なって、いっそうひどいのでございました
警察 沙汰 に なる た 事件 も 二 度 や 三 度 だ は ござる ます ん	警察沙汰になった事件も二度や三度ではございません
村 の 人々 は すっかり おびえる て しまう 、 しまいに は 父 の 姿 を 見る と 、 誰 も 皆 あわてる て 逃げる よう に さえ なる て しまう ます た	村の人々はすっかりおびえてしまい、しまいには父の姿を見ると、誰も皆あわてて逃げるようにさえなってしまいました
何しろ 父 と 来る た 恐ろしい 力 の 強い 人 で 、 怒る た と なる と 全く 手 が つける られる ない なる の だ ござる ます	何しろ父と来たら恐ろしく力の強い人で、怒ったとなると全く手がつけられなくなるのでございます
つい 先週 も 、 父 は 村 の 鍛冶 屋 さん を 橋 の 欄干 から 川 の 中 へ 突き落とす て しまう ます た	つい先週も、父は村の鍛冶屋さんを橋の欄干から川の中へ突き落としてしまいました
訴える 出る という の を 、 かき集める た お金 を 出す て やる と 勘弁 する て いただく た ほど だ ござる ます	訴え出るというのを、かき集めたお金を出してやっと勘弁していただいたほどでございます
父 の お 友だち と いう て は 、 漂泊 の ロマ の 一団 だけ だ 、 グリムズビ・ロイロット 家 の 地所 として 残る て いる わずか 数 エーカー ほど の 茨 の 茂る た 土地 で 、 野宿 する て よい と 言う て ある そう です	父のお友だちといっては、漂泊のロマの一団だけで、ロイロット家の地所として残っているわずか数エーカーほどの茨の茂った土地で、野宿してよいと言ってあるそうです
その 交換 条件 として 、 父 は いつ でも そこ で の 寝泊まり を 許す れる て いる ます ので 、 時に よる と 父 は 同行 する て 何 週間 も 処々方々 を 回る こと さえ ござる ます た	その交換条件として、父はいつでもそこでの寝泊まりを許されていますので、時によると父は同行して何週間も処々方々を回ることさえございました
また 父 は 、 インド 産 の 動物 が 好き だ 、 現地 から よく 動物 を 買い入れる て おる ます	また父は、インド産の動物が好きで、現地からよく動物を買い入れております
現に ただ いま も 、 屋敷 に は 豹 が 一 頭 と ヒヒ が 一 頭 、 いずれ も 放し飼い に なる て おる ます て 、 いっそう 村人 を 怖がる せる 原因 に も なる て おる ます	現にただいまも、屋敷には豹が一頭とヒヒが一頭、いずれも放し飼いになっておりまして、いっそう村人を怖がらせる原因にもなっております
この お話 で 、 かわいそう だ 姉 ジュリア と わたくし と の 暮らし が 、 今 まで 決して 楽しい もの だ ない た こと は お わかる に なる た と 存じる ます	このお話で、かわいそうな姉ジュリアとわたくしとの暮らしが、今まで決して楽しいものでなかったことはおわかりになったと存じます
屋敷 に は ひとり の 召使い さえ おりる ます ん ので 、 長い 間 、 家 の こと は わたくし ども 姉妹 の 手 で すべて 看る て まいる ます た	屋敷にはひとりの召使いさえおりませんので、長い間、家のことはわたくしども姉妹の手ですべて看てまいりました
姉 の 享年 は まだ 三 〇 です た のに 、 その 髪 は 白髪 が ちらほら と 、 ただ いま の わたくし と 同じ よう に	姉の享年はまだ三〇でしたのに、その髪は白髪がちらほらと、ただいまのわたくしと同じように
お 姉 さま は お 亡くなる に	お姉さまはお亡くなりに
ちょうど 二年前 に	ちょうど二年前に
実は お話し する たい の も 、 この 姉 の 死 に つく て だ ござる ます	実はお話ししたいのも、この姉の死についてでございます
ご 想像 つく か と 存じる ます が 、 この よう だ 暮らし です ので 、 同 世代 同 身分 の 人 と は なかなか 付き合い が 難しい	ご想像つくかと存じますが、このような暮らしですので、同世代同身分の人とはなかなか付き合いが難しく
けれども 、 母 の 妹 に当たる ホノーリア・ウェストファイル という 叔母 が ハロウ の 近く に 住む で おる ます て 、 父 も ここ を 訪ねる こと だけ は 許す て くださる ます	けれども、母の妹に当たるホノーリア・ウェストファイルという叔母がハロウの近くに住んでおりまして、父もここを訪ねることだけは許してくださいます
ジュリア は 二年前 の クリスマス に そこ へ 参る ます て 、 休職 中 の 海軍 少佐 の 方 と 出会う 、 婚約 の 運び と なる た の だ ござる ます	ジュリアは二年前のクリスマスにそこへ参りまして、休職中の海軍少佐の方と出会い、婚約の運びとなったのでございます
父 は この 婚約 を 知る て も 別段 何 も 文句 を 申す ます ん です た が 、 式 の 日取り の 二週間前 に 、 あの 恐ろしい 事件 の ため に 、 わたくし は たった ひとり の 姉 を 失う て しまう た の です	父はこの婚約を知っても別段何も文句を申しませんでしたが、式の日取りの二週間前に、あの恐ろしい事件のために、わたくしはたったひとりの姉を失ってしまったのです
シャーロック・ホームズ は ずっと 目 を 閉じる 、 椅子 の 背 に 頭 を 押しつける て いる た が 、 この とき 細目 を 開ける て 、 依頼 人 の 方 を ちらりと 見る た	シャーロック・ホームズはずっと目を閉じ、椅子の背に頭を押しつけていたが、このとき細目を開けて、依頼人の方をちらりと見た
願わくは 、 詳しい お話 を	願わくは、詳しいお話を
隅々 まで お話し 致す ます	隅々までお話し致します
あまりの 恐ろしい さ に 、 今 も わたくし の 記憶 に はっきり と 焼き付く て おる ます	あまりの恐ろしさに、今もわたくしの記憶にはっきりと焼き付いております
わたくし ども の 屋敷 は 、 申しあげる ます た よう に たいへん 古い 、 ただいま 使う て おる ます の は 一 棟 だけ だ ござる ます	わたくしどもの屋敷は、申しあげましたようにたいへん古く、ただいま使っておりますのは一棟だけでございます
寝室 は 一 階 に ござる ます て 、 中程 に 居間 が ござる ます	寝室は一階にございまして、中程に居間がございます
一 番目 が グリムズビ・ロイロット さん の 寝室 、 その 隣 が 姉 、 次 が わたくし の に なる て おる ます	一番目がロイロットさんの寝室、その隣が姉、次がわたくしのになっております
寝室 同士 は 行き来 が できる ます ん が 、 各 部屋 の 入り口 は 同じ 廊下 に 並ぶ で おる ます	寝室同士は行き来ができませんが、各部屋の入り口は同じ廊下に並んでおります
こんな 説明 で よろしい です う か	こんな説明でよろしいでしょうか
問題 ある ます ん	問題ありません
寝室 の 窓 から は 庭 の 芝 地 が 見える ます	寝室の窓からは庭の芝地が見えます
事件 当夜 は 、 グリムズビ・ロイロット さん は 早くから 寝室 へ 下がる ます た が 、 おそらく お 休み に なる た の だ は ない と 思う ます	事件当夜は、ロイロットさんは早くから寝室へ下がりましたが、おそらくお休みになったのではないと思います
姉 に よる ば 、 父 が いつも 吸う インド 煙草 の きつい 臭い に ひどい 悩ます れる た と	姉によれば、父がいつも吸うインド煙草のきつい臭いにひどく悩まされたと
です ので 、 姉 は 自室 を 出る て 、 隣 の わたくし の 部屋 へ 参る ます た	ですので、姉は自室を出て、隣のわたくしの部屋へ参りました
しばらく わたくし ども は 、 すぐ 先 に 迫る た 姉 の 婚礼 の 話 を する て おる ます た	しばらくわたくしどもは、すぐ先に迫った姉の婚礼の話をしておりました
十 一 時 に 姉 は 帰る と て 立ち上がる ます た が 、 ふと 戸口 の ところ で 立ち止まる 、 振り返る て こんな こと を 申す ます た	十一時に姉は帰るとて立ち上がりましたが、ふと戸口のところで立ち止まり、振り返ってこんなことを申しました
ねえ 、 ヘレン・ストーナ	ねえ、ヘレン
あなた 真夜中 に 、 誰か が 口笛 を 吹く て いる の を 聞く ない	あなた真夜中に、誰かが口笛を吹いているのを聞かない
いいえ 、 何 も	いいえ、何も
まさか 、 あなた が 眠る ながら 口笛 を 吹く わけ だ も ない です う し	まさか、あなたが眠りながら口笛を吹くわけでもないでしょうし
当たり前 じゃ ない の	当たり前じゃないの
どうして	どうして
だって この 頃 、 毎晩 の よう に 、 真夜中 の 三時 頃 かしら 、 低い 口笛 が 聞こえる て ね	だってこの頃、毎晩のように、真夜中の三時頃かしら、低い口笛が聞こえてね
いつも 眠り が 浅い から 、 音 が 聞こえる と 目 が 覚める ちゃう て	いつも眠りが浅いから、音が聞こえると目が覚めちゃって
どこ で 吹く てる の か 分かる ない ん だ けど … … 隣 の 部屋 か 、 ひょっと する と 芝 地 の 方 か 、 一度 あなた に 聞く ない ちゃ と 思う てる た の	どこで吹いてるのか分からないんだけど……隣の部屋か、ひょっとすると芝地の方か、一度あなたに聞かなくちゃと思ってたの
聞く ない けど 、 あたり に いる ロマ の 仕業 じゃ ない	聞かないけど、あたりにいるロマの仕業じゃない
そう かも しれる ない	そうかもしれない
でも 、 芝 地 で 吹く ん だ と する と 、 あなた の 耳 に も 聞こえる そう だ もの ね	でも、芝地で吹くんだとすると、あなたの耳にも聞こえそうなものね
でも 、 あたし 、 姉さん と 違う て 、 安眠 する ちゃう から	でも、あたし、姉さんと違って、安眠しちゃうから
まあ 、 何 に する くだらない こと ね	まあ、何にせよくだらないことね
と 、 姉 は 笑う て 、 わたくし の 部屋 の 戸 を 閉める ます た	と、姉は笑って、わたくしの部屋の戸を閉めました
そして それ に つづく て 姉 が 自室 の 鍵 を かける 音 が 聞こえる ます た	そしてそれにつづいて姉が自室の鍵をかける音が聞こえました
なるほど	なるほど
と シャーロック・ホームズ が 答える	とホームズが答える
毎晩 、 部屋 に 鍵 を かける の です か	毎晩、部屋に鍵をかけるのですか
はい 、 いつも	はい、いつも
どうして	どうして
父 が 豹 と ヒヒ を 飼う て いる こと は 申す ます た ね 、 鍵 を かける ない こと に は 、 安心 する て 眠れる ない ので	父が豹とヒヒを飼っていることは申しましたね、鍵をかけないことには、安心して眠れないので
無論 です	無論です
どうぞ 先 を お話 くださる	どうぞ先をお話ください
その 夜 は 眠れる ます ん です た	その夜は眠れませんでした
何だか 胸騒ぎ が する て	何だか胸騒ぎがして
前 に も 申す ます た が 、 姉 と わたくし と は 双子 だ ござる ます た	前にも申しましたが、姉とわたくしとは双子でございました
ご存じ か と 思う ます が 、 強い 縁 で 結ぶ れる た ふたつ の 魂 という の は 、 お互い の こと を ものすごい 敏感 に 感じる の です	ご存じかと思いますが、強い縁で結ばれたふたつの魂というのは、お互いのことをものすごく敏感に感じるのです
それに その 晩 は 嵐 で 、 外 に は 風 の うなる が ひる ゅうひゅうと 聞こえる 、 窓 は 雨 に 叩く れる て 鳴る て いる ます た	それにその晩は嵐で、外には風のうなりがひゅうひゅうと聞こえ、窓は雨に叩かれて鳴っていました
その 時 です 、 激しい 嵐 の 音 の 中 に 、 突然 、 絹 を 裂く よう だ 女 の 声 が 聞こえる ます た	その時です、激しい嵐の音の中に、突然、絹を裂くような女の声が聞こえました
間違い ない 、 姉 の 声 です	間違いなく、姉の声です
わたくし は 起き抜け に 肩掛け を 巻き付ける 、 廊下 へ 飛び出す ます た	わたくしは起き抜けに肩掛けを巻き付け、廊下へ飛び出しました
わたくし が 扉 を 開ける た とき 、 姉 の 言う た とおり の 低い 口笛 が 一声 、 聞こえる た よう だ 気 が する ます た	わたくしが扉を開けたとき、姉の言ったとおりの低い口笛が一声、聞こえたような気がしました
それ に 続く て 、 が ちゃんと 何 か 重い 金物 で も 堕ちる た よう だ 音 が する ます た	それに続いて、がちゃんと何か重い金物でも堕ちたような音がしました
廊下 を 駆け出す て いく ます と 、 姉 の 部屋 で 、 扉 の 鍵 を 外す 音 が いたす ます て 、 扉 が すい っと 開く ます た	廊下を駆け出していきますと、姉の部屋で、扉の鍵を外す音がいたしまして、扉がすぅっと開きました
何 が 出る て くる の か と 、 わたくし は 怖い なる て 息 を 呑む ます た	何が出てくるのかと、わたくしは怖くなって息を呑みました
廊下 の ランプ の 光 を 浴びる て 、 姉 が 戸口 に 現れる た の です が 、 恐怖 で 真っ青 に なる た 顔 、 すがる よう だ 手つき 、 千鳥足 で ふらふら と 進み出る て くる の です	廊下のランプの光を浴びて、姉が戸口に現れたのですが、恐怖で真っ青になった顔、すがるような手つき、千鳥足でふらふらと進み出てくるのです
わたくし は すぐ に 駆け寄る て 、 姉 の 身体 を 両 腕 で 抱きとめる ます た	わたくしはすぐに駆け寄って、姉の身体を両腕で抱きとめました
すると 姉 の 足 の 力 が 抜ける て 、 その 場 に 倒れる て しまう た の だ ござる ます	すると姉の足の力が抜けて、その場に倒れてしまったのでございます
そして 、 どこ か が ひどい 痛む らしい 、 激しい 身もだえ を する て 、 手足 を ぶるぶる と 震わせる て いる の です	そして、どこかがひどく痛むらしく、激しく身もだえをして、手足をぶるぶると震わせているのです
はじめ 、 姉 は わたくし が 分かる ない の か と 思う て いる ます た が 、 わたくし が 中腰 に なる と 、 突然 恐ろしい 声 を 絞り出す て	はじめ、姉はわたくしが分からないのかと思っていましたが、わたくしが中腰になると、突然恐ろしい声を絞り出して
忘れる ます ん 、 お願い 、 助ける て	忘れません、お願い、助けて
ヘレン・ストーナ 、 ひも が 、 まだ ら の ひも が	ヘレン、ひもが、まだらのひもが
と	と
それから 姉 は 、 もっと 何 か 言う た そう に する て 、 指 を 高い 上げる て 父 の 部屋 の 方 を 突き刺す よう に 指す ます た が 、 またもや 全身 に ひきつける が 起こる て 、 物 が 言える ます ん です た	それから姉は、もっと何か言いたそうにして、指を高く上げて父の部屋の方を突き刺すように指しましたが、またもや全身にひきつけが起こって、物が言えませんでした
わたくし が 父 の 名 を 呼ぶ ながら 廊下 を 駆け出す た ところ 、 化粧 着 を 引っかける て 廊下 へ 出る て くる た 父 と ばったり 出会う ます た	わたくしが父の名を呼びながら廊下を駆け出したところ、化粧着を引っかけて廊下へ出てきた父とばったり出会いました
そこで 一緒 に なる て 再び 姉 の ところ へ 戻る て みる ます と 、 姉 は 気 を 失う て おる ます た	そこで一緒になって再び姉のところへ戻ってみますと、姉は気を失っておりました
父 は 姉 の 口 に ブランデイ を つぎ込む やら 、 村 の 医師 を 迎える やら 致す ます た が 、 手 の 施す よう も ない 、 ついに 姉 は 意識 の 戻る ぬ まま ゆっくり 息 を 引き取る て しまう ます た	父は姉の口にブランデイをつぎ込むやら、村の医師を迎えるやら致しましたが、手の施しようもなく、ついに姉は意識の戻らぬままゆっくり息を引き取ってしまいました
これ が 愛する 姉 の 恐ろしい 最期 だ ござる ます た	これが愛する姉の恐ろしい最期でございました
では 、 ひとつ	では、ひとつ
と シャーロック・ホームズ が 口 を 挟む	とホームズが口を挟む
口笛 と 金属 音 という の は 確か です か	口笛と金属音というのは確かですか
聞く 間違い で も ない	聞き間違いでもない
その こと は 検視 の とき 係官 から も お 訊ねる が ある ます た が 、 わたくし は 確か に 聞く た と 、 そう 思う の です	そのことは検視のとき係官からもお訊ねがありましたが、わたくしは確かに聞いたと、そう思うのです
もっとも 、 激しい 嵐 で 古い 家 が 絶えず 軋む で おる ます た から 、 ひょっと する と 、 聞く 違える た の かも しれる ます ん	もっとも、激しい嵐で古い家が絶えず軋んでおりましたから、ひょっとすると、聞き違えたのかもしれません
お 姉 さま の 服 は	お姉さまの服は
寝間着 の まま だ ござる ます た	寝間着のままでございました
右手 に は マッチ の 燃えさし を 一 本 、 左手 に は マッチ の 箱 を	右手にはマッチの燃えさしを一本、左手にはマッチの箱を
すると お 姉 さま は 、 何 か を 察知 する て 、 マッチ を 擦る て 辺り を ご覧 に なる た	するとお姉さまは、何かを察知して、マッチを擦って辺りをご覧になった
なるほど	なるほど
それで 検視 官 は 、 どの よう だ ご 結論 を	それで検視官は、どのようなご結論を
ずいぶん 詳しい 取り調べ を なさる ます た	ずいぶん詳しい取り調べをなさいました
父 の 日頃 の 行い が あまりに も 悪い た もの です から	父の日頃の行いがあまりにも悪かったものですから
けれど 、 姉 の 死因 について 、 はっきり と する た こと は 分かる ぬ じ まい です た	けれど、姉の死因について、はっきりとしたことは分からずじまいでした
内側 から 鍵 が かかる て いる た こと は 、 わたくし が 証言 致す ます た し 、 窓 に は 旧式 の 鎧戸 が つく て いる て 、 夜 に は いつも 太い 鉄 の 棒 を はめる て 閉ざす て おる ます	内側から鍵がかかっていたことは、わたくしが証言致しましたし、窓には旧式の鎧戸がついていて、夜にはいつも太い鉄の棒をはめて閉ざしております
四方 の 壁 も 全部 叩く て みる ます た が 、 どこ も しっかり 堅い と しか 分かる ます ん です た	四方の壁も全部叩いてみましたが、どこもしっかり堅いとしか分かりませんでした
床 も つぶさに 調べる ます た が 、 同じ こと です た	床もつぶさに調べましたが、同じことでした
煙突 は 太い の です が 、 内部 に 釘 が 四 本 も 横 に 通す て ある ます	煙突は太いのですが、内部に釘が四本も横に通してあります
ですから 、 亡くなる た とき 姉 ひとり だ た こと に は 間違い ござる ます ん	ですから、亡くなったとき姉ひとりだったことには間違いございません
それに 姉 の 身体 に は 傷痕 ひとつ 見つかる ない の です	それに姉の身体には傷痕ひとつ見つからないのです
毒殺 について は	毒殺については
お 医者 さま が お 調べ に なる ます た が 、 結果 は 何 も	お医者さまがお調べになりましたが、結果は何も
では 、 お 気の毒 だ お 姉 さま は 何 の 原因 で 亡くなる た の だ と	では、お気の毒なお姉さまは何の原因で亡くなったのだと
姉 は 激しい 恐怖 の ため に 、 びっくり する て 、 それ で 死ぬ だ の だ と 思う ます	姉は激しい恐怖のために、びっくりして、それで死んだのだと思います
もっとも 、 何 が 姉 を 驚く せる た の か は 分かる ます ん … …	もっとも、何が姉を驚かせたのかは分かりません……
ロマ は 、 その とき 、 敷地 の 中 に いる た の です か	ロマは、そのとき、敷地の中にいたのですか
はい 、 だいたい いつも 、 どこ か に おりる ます	はい、だいたいいつも、どこかにおります
ふむ	ふむ
—— それ から 何 か お 心当たり は ある ます か	——それから何かお心当たりはありますか
ひも … … まだ ら の ひも 、 に	ひも……まだらのひも、に
姉 が 夢中 に 叫ぶ だ うわ言 か と も 思う 、 また それ は 敷地 に いる ロマ の こと だ は ない か と も 思い … … 多く の 者 が 頭 に 水玉 の 模様 が ある ハンカチーフ を 巻く て おる ます が 、 それ が 姉 の 使う た 言葉 に 関係 が ある の か は 、 ちょっと	姉が夢中に叫んだうわ言かとも思い、またそれは敷地にいるロマのことではないかとも思い……多くの者が頭に水玉の模様があるハンカチーフを巻いておりますが、それが姉の使った言葉に関係があるのかは、ちょっと
シャーロック・ホームズ も よく 分かる ない という 風 に 、 首 を 横 に 振る	ホームズもよく分からないという風に、首を横に振る
まさに 深い 海 、 です ね	まさに深い海、ですね
どうぞ 先 を お話 くださる	どうぞ先をお話ください
事件 から 向こう 二 年間 、 先頃 まで さみしい 暮らす て まいる ます た	事件から向こう二年間、先頃までさみしく暮らしてまいりました
けれども 、 一ヶ月前 、 長年 の 友人 の おかげ で 、 わたくし に も 結婚 を 申し込む 方 が 現れる ます た	けれども、一ヶ月前、長年の友人のおかげで、わたくしにも結婚を申し込む方が現れました
お 名前 は アーミティッジ——パーシィ・アーミティッジ——アーミティッジ 家 の 次男 で 、 レディング の そば の クレイン・ウォータ に お 住む です	お名前はアーミティッジ——パーシィ・アーミティッジ——アーミティッジ家の次男で、レディングのそばのクレイン・ウォータにお住みです
父 も 反対 致す ます ん ので 、 春 の うち に 式 を 挙げる 予定 です	父も反対致しませんので、春のうちに式を挙げる予定です
ところが 昨日 から 屋敷 で 西 棟 の 修理 が 始まる 、 わたくし の 寝室 は 壁 に 穴 が 開く ます た ので 、 やむを得ず わたくし は 、 亡くなる た 姉 の 部屋 へ 、 姉 の 使う て いる た 寝台 へ 移る こと に なる ます た	ところが昨日から屋敷で西棟の修理が始まり、わたくしの寝室は壁に穴が開きましたので、やむを得ずわたくしは、亡くなった姉の部屋へ、姉の使っていた寝台へ移ることになりました
考える て みる て くださる 、 昨夜 の わたくし が どれ だけ 恐ろしい て ふるえる た こと か	考えてみてください、昨夜のわたくしがどれだけ恐ろしくてふるえたことか
眠れる ぬ に 姉 の 恐ろしい 最期 が 頭 から 離れる ぬ に いる と 、 真夜中 の 静けさ の 中 に 、 姉 の 死 の 先触れ と なる ます た あの 低い 口笛 が 聞こえる た の だ ござる ます	眠れずに姉の恐ろしい最期が頭から離れずにいると、真夜中の静けさの中に、姉の死の先触れとなりましたあの低い口笛が聞こえたのでございます
わたくし は 飛び起きる て ランプ を つける ます た が 、 部屋 に は 何 も 見あたる ます ん	わたくしは飛び起きてランプをつけましたが、部屋には何も見あたりません
でも 、 もう 恐ろしい て 寝台 に も 戻れる ぬ 、 そこで 着替える て 、 夜明け が 来る と 家 を 抜け出す 、 お 向かい の クラウン ・ イン という 旅館 で 二 輪 馬車 を 頼む ます て 、 レザヘッド駅 へ 駆けつける 、 それから こうして 今朝 、 こちら へ お 助け を お願い に 参る た の だ ござる ます	でも、もう恐ろしくて寝台にも戻れず、そこで着替えて、夜明けが来ると家を抜け出し、お向かいのクラウン・インという旅館で二輪馬車を頼みまして、レザヘッド駅へ駆けつけ、それからこうして今朝、こちらへお助けをお願いに参ったのでございます
賢明 だ 行動 です	賢明な行動です
お話 は それ で すべて	お話はそれですべて
ええ	ええ
お嬢さん 、 まだ ある ます	お嬢さん、まだあります
父親 の こと を お 隠し です	父親のことをお隠しです
どういう こと です う か	どういうことでしょうか
返事 の 代わり に 、 シャーロック・ホームズ は 依頼 人 の 膝 に 置く れる て いる た 腕 を 取る 、 黒い レース の 袖口 を つまむ で 折り返す た	返事の代わりに、ホームズは依頼人の膝に置かれていた腕を取り、黒いレースの袖口をつまんで折り返した
五つ の 小さな 青 痣 —— 五 本 指 で つける た 痕 —— が 、 白い 手首 に 残す れる て いる た	五つの小さな青痣——五本指でつけた痕——が、白い手首に残されていた
ひどい 扱い を 受ける て いらっしゃる	ひどい扱いを受けていらっしゃる
シャーロック・ホームズ が 言う た	ホームズが言った
ご 婦人 は 顔 を 赤らめる 、 痣 の つく た 手首 を 袖の下 に 隠す た	ご婦人は顔を赤らめ、痣のついた手首を袖の下に隠した
すぐ 手 の 出る 人 で 、 きっと 力 の 加減 が わかる ない の です	すぐ手の出る人で、きっと力の加減がわからないのです
長い 沈黙 が 続く た	長い沈黙が続いた
シャーロック・ホームズ は 両手 に あご を 乗せる 、 暖炉 に 燃えさかる 火 の 中 を じっと 見つめる て いる た が 、 やがて 、	ホームズは両手にあごを乗せ、暖炉に燃えさかる火の中をじっと見つめていたが、やがて、
深い 事情 が ある よう だ	深い事情があるようで
と 口 を 開く た	と口を開いた
これから どう 動く か を 決める 前 に 、 知る て おく たい こと が 山 の よう に ある ます が 、 一刻 の 猶予 も ある ます ん	これからどう動くかを決める前に、知っておきたいことが山のようにありますが、一刻の猶予もありません
いかが です か 、 今日 ストーク・モラン へ 出向く て 、 父親 に 知れる ない よう 見せる て いただく の は	いかがですか、今日ストーク・モランへ出向いて、父親に知れないよう見せていただくのは
折 よい 父 も 大事 だ 用 で ロンドン へ 出る と 申す て おる ます た	折よく父も大事な用でロンドンへ出ると申しておりました
日 中 は 留守 に する て いる です う から 、 大丈夫 だ ござる ます う	日中は留守にしているでしょうから、大丈夫でございましょう
家政 婦 が ひとり おる ます が 、 耄碌 する て いる お婆さん です から 、 外 へ 出る て もらう の は 訳 ない か と	家政婦がひとりおりますが、耄碌しているお婆さんですから、外へ出てもらうのは訳ないかと
好都合 です	好都合です
君 も 出かける のに 異存 は ない う 、 ワトソン	君も出かけるのに異存はなかろう、ワトソン
異議 ない	異議なし
では ふたり で 参る ます	ではふたりで参ります
あなた は どう なさる ます か	あなたはどうなさいますか
せっかく ロンドン へ 参る ます た ので 、 これから ひとつ ふたつ 用 を 済ませる たい と 存じる ます	せっかくロンドンへ参りましたので、これからひとつふたつ用を済ませたいと存じます
ですが 十 二 時 の 汽車 で 帰る ます ので 、 先生 方 の ご 来訪 に は 間に合う か と 存じる ます	ですが十二時の汽車で帰りますので、先生方のご来訪には間に合うかと存じます
では お 昼過ぎ に 、 ふたり で 伺う ます	ではお昼過ぎに、ふたりで伺います
私 も 二 、 三 、 片づける て おく たい こと が ある ます ので	私も二、三、片づけておきたいことがありますので
よろしい ば 、 朝食 など いかが です か	よろしければ、朝食などいかがですか
いえ 、 おく まい ない	いえ、おかまいなく
悩み を 打ち明ける ます て 、 心 が 軽い なる ます た	悩みを打ち明けまして、心が軽くなりました
午後 お目にかかる の を お待ち 致す て おる ます	午後お目にかかるのをお待ち致しております
依頼 人 は 黒い 面 紗 を 顔 の 前 に 下ろす と 、 静か に 退室 する た	依頼人は黒い面紗を顔の前に下ろすと、静かに退室した
今 の 話 を どう 思う ね 、 ワトソン	今の話をどう思うね、ワトソン
シャーロック・ホームズ が 、 椅子 に もたれかかる ながら 訊ねる	シャーロック・ホームズが、椅子にもたれかかりながら訊ねる
ずいぶん 暗い 、 悲惨 だ 話 だ と 思う	ずいぶん暗く、悲惨な話だと思う
暗い 、 悲惨 … … そう だ ね	暗く、悲惨……そうだね
あの ご 婦人 の 言う た よう に 、 床 に も 壁 に も 異常 が ない 、 戸 も 窓 も 煙突 も 通れる ない と する ば 、 その 姉 なり 人 が 不可解 だ 死 を 遂げる た とき に 、 たった ひとり だ た こと は 間違い ない という こと に なる	あのご婦人の言ったように、床にも壁にも異常がなく、戸も窓も煙突も通れないとすれば、その姉なる人が不可解な死を遂げたときに、たったひとりだったことは間違いないということになる
では 、 真夜中 の 口笛 は 、 ご 婦人 が 死に際 に もたらす た 不思議 だ 言葉 は 、 どう なる	では、真夜中の口笛は、ご婦人が死に際にもたらした不思議な言葉は、どうなる
見当 も 付く ん よ	見当も付かんよ
考える 合う せる て みる う	考え合わせてみよう
夜 の 口笛 の こと	夜の口笛のこと
老 医師 と 親密 だ ロマ たち の 存在	老医師と親密なロマたちの存在
娘 の 結婚 を 邪魔 する ば 、 その 医者 が 得 を する という はっきり する た 事実	娘の結婚を邪魔すれば、その医者が得をするというはっきりした事実
死に際 の ひも という 言葉 の 謎	死に際のひもという言葉の謎
それから 最期 に ヘレン・ストーナ ・ ヘレン・ストーナ の 聞く た 金属 音 （ これ は 鎧戸 の 棒 が 元 の ところ に 戻る た 音 かも しれる ぬ が ）	それから最期にヘレン・ストーナの聞いた金属音（これは鎧戸の棒が元のところに戻った音かもしれぬが）
この 方向 で 、 謎 を 解き明かす そう だ と は 考える られる ない だ う か	この方向で、謎を解き明かせそうだとは考えられないだろうか
だが ロマ たち が 何 を する た と	だがロマたちが何をしたと
何 だ う ね	何だろうね
そんな 説明 、 いくらでも 穴 が ある	そんな説明、いくらでも穴がある
ご もっとも	ごもっとも
だからこそ 今日 ストーク・モラン まで 行く 価値 が ある と 思う	だからこそ今日ストーク・モランまで行く価値があると思う
その 穴 が 致命 的 だ の か どう か 、 これ で 説明 可能 だ の か どう か 、 確かめる たい	その穴が致命的なのかどうか、これで説明可能なのかどうか、確かめたい
おや 、 何ごと か ね	おや、何ごとかね
突然 、 友人 が 声 を 張り上げる た か と 思う と 、 いきなり 扉 が 勢い よく 開く て 、 大男 が 入り口 に 立ちはだかる た	突然、友人が声を張り上げたかと思うと、いきなり扉が勢いよく開いて、大男が入り口に立ちはだかった
男 の 服装 は 、 学者 と 農園 主 の それ が 変 に 混ざる た 風 だ ある た	男の服装は、学者と農園主のそれが変に混ざった風であった
黒い トップ ・ ハット に 長い フロック コート 、 長い ゲートル という 格好 で 、 手 で 狩猟 鞭 を 振り回す て いる	黒いトップ・ハットに長いフロックコート、長いゲートルという格好で、手で狩猟鞭を振り回している
背 が 高い 、 帽子 が 入り口 の 鴨居 すれすれ だ 、 肩幅 も ぎりぎり だ ある た	背が高く、帽子が入り口の鴨居すれすれで、肩幅もぎりぎりであった
その 大きな 顔 は 皺 だらけ で 日 に 焼ける て いる て 、 鬼 の よう だ 形相 で 我々 を ひとりひとり にらみつける 、 怒り に 燃える くぼむ だ 眼 、 肉 の 薄い 高い 鼻 など は 、 凶暴 だ 猛禽 の よう だ ある た	その大きな顔は皺だらけで日に焼けていて、鬼のような形相で我々をひとりひとりにらみつけ、怒りに燃えるくぼんだ眼、肉の薄い高い鼻などは、凶暴な猛禽のようであった
どっち が シャーロック・ホームズ だ	どっちがホームズだ
私 の 名前 です	私の名前です
が 、 まず は 名乗る べし だ は	が、まずは名乗るべきでは
友人 は 静か に 問い返す た	友人は静かに問い返した
わし は ストーク・モラン の グリムズビ・ロイロット だ	わしはストーク・モランのグリムズビ・ロイロットだ
どうも 、 先生	どうも、先生
と シャーロック・ホームズ は おだやか に 切り返す	とホームズはおだやかに切り返す
どうぞ おかけ くださる	どうぞおかけください
お断り だ	お断りだ
わし の 義理 の 娘 が さっき ここ へ 来る た な	わしの義理の娘がさっきここへ来たな
入る の を 見る た ぞ	入るのを見たぞ
お前 に 何 を する ゃべりやがった	お前に何をしゃべりやがった
今年 の 寒い さ はたち が 悪い よう だ	今年の寒さはたちが悪いようで
シャーロック・ホームズ は 言う た	ホームズは言った
何 を しゃべる おる た と 聞く とる の だ	何をしゃべりおったと聞いとるのだ
老 医師 は 烈火 の ごとし 怒る た	老医師は烈火のごとく怒った
ですが 麦 の 方 は 出来 が いい そう だ	ですが麦の方は出来がいいそうで
と 友人 は 少し も 動じる ない	と友人は少しも動じない
この 、 はぐらかす おる て	この、はぐらかしおって
闖入 者 は 一 歩 踏みだす 、 鞭 を ふるわす	闖入者は一歩踏みだし、鞭をふるわす
この クソ ガキ め が	このクソガキめが
知る とる ぞ	知っとるぞ
シャーロック・ホームズ 、 貴様 の 職 は お節介 屋 だ と な	ホームズ、貴様の職はお節介屋だとな
友人 は にこり と 笑う た	友人はにこりと笑った
出しゃばる 屋	出しゃばり屋
満面 の 笑み を 浮かべる	満面の笑みを浮かべる
この スコットランド ・ ヤード の 子役 人 が	このスコットランド・ヤードの子役人が
ついに シャーロック・ホームズ は くすくす と 笑う 出す た	ついにホームズはくすくすと笑い出した
その 冗談 、 傑作 です	その冗談、傑作です
お 帰り の 際 は 戸締まり を よろしく	お帰りの際は戸締まりをよろしく
すきま風 が 寒い ので	すきま風が寒いので
用 が 済む ば こっち から 帰る て やる	用が済めばこっちから帰ってやる
他人 の こと に あまり 首 を つっこむ な よ	他人のことにあまり首をつっこむなよ
ヘレン・ストーナ の 娘 が 来る た の は 知る とる 、 つける て くる た から な	ストーナの娘が来たのは知っとる、つけてきたからな
わし を 相手 に する と 後悔 する ぞ	わしを相手にすると後悔するぞ
見る	見ろ
老 医師 は つかつか と 進む と 、 暖炉 の 火 掻く 棒 を つかむ 上げる 、 大きな 手 で 折り曲げる て みせる た	老医師はつかつかと進むと、暖炉の火掻き棒をつかみ上げ、大きな手で折り曲げてみせた
せいぜい わし の 手 に 気 を つける こる た な	せいぜいわしの手に気をつけるこったな
老 医師 は 吠える た あと 、 曲がる た 火 掻く 棒 を 暖炉 の 中 へ 放り込む 、 大手 を 振る て 部屋 から 出る て いく た	老医師は吠えたあと、曲がった火掻き棒を暖炉の中へ放り込み、大手を振って部屋から出ていった
ずいぶん 愛嬌 の ある 人物 だ	ずいぶん愛嬌のある人物だ
と 、 シャーロック・ホームズ は 笑う 出す ながら 、 僕 も 身体 は 大きい ない が 、 待つ て いる ば 決して 彼 より 力 は 弱い ない こと を 披露 できる た の だ が	と、ホームズは笑い出しながら、僕も身体は大きくないが、待っていれば決して彼より力は弱くないことを披露できたのだが
そう いう て 、 鉄 の 火 掻く 棒 を 取り上げる と 、 ぐいと 力 を 入れる て 元 の 通り まっすぐ に 伸ばす た	そういって、鉄の火掻き棒を取り上げると、ぐいと力を入れて元の通りまっすぐに伸ばした
御仁 、 僕 と 警視庁 の 役人 を 混同 する と は 、 なん たり 暴挙	御仁、僕と警視庁の役人を混同するとは、なんたる暴挙
だが 今 の 出来事 は 、 僕 等 の 調査 の いい 薬味 に なる	だが今の出来事は、僕等の調査のいい薬味になる
あの お嬢さん が 、 あの 獣 に 後 を つける られる た こと だ 、 困る た こと に なる ぬ ば よい の だ が	あのお嬢さんが、あの獣に後をつけられたことで、困ったことにならねばよいのだが
さて 、 ワトソン 、 朝食 と 行く う	さて、ワトソン、朝食と行こう
その あと で 僕 は 博士会館 へ 行く て くる	そのあとで僕は博士会館へ行ってくる
事件 に 役立つ 資料 が 何 か ある と 思う	事件に役立つ資料が何かあると思う
シャーロック・ホームズ が 外 から 帰る て くる た の は 、 一時 頃 だ た	シャーロック・ホームズが外から帰ってきたのは、一時頃だった
手 に 水色 の 紙 を 持つ て いる て 、 数字 や 抜き 書き が いっぱい に 書き込む れる て いる た	手に水色の紙を持っていて、数字や抜き書きがいっぱいに書き込まれていた
亡くなる た 細君 の 遺言 状 を 見る て くる た	亡くなった細君の遺言状を見てきた
正確 だ 内容 を 考える ため に 、 関係 する 投下 資本 の 現在 価格 を 計算 する ない て は なる ない た	正確な内容を考えるために、関係する投下資本の現在価格を計算しなくてはならなかった
細君 の 死ぬ だ 当時 、 年収 で 一 一 〇 〇 ポンド 弱 も ある た もの が 、 今 は 農産物 の 価格 下落 で 、 せいぜい 七 五 〇 ポンド という ところ	細君の死んだ当時、年収で一一〇〇ポンド弱もあったものが、今は農産物の価格下落で、せいぜい七五〇ポンドというところ
そして 娘 が 結婚 する と 、 ひとり につき 年収 二 五 〇 ポンド ずつ 受け取れる よう に なる て ある	そして娘が結婚すると、ひとりにつき年収二五〇ポンドずつ受け取れるようになってある
それ ゆえ に 、 もし ふたり の 娘 が 嫁ぐ で しまう ば 、 うま味 が 少し だけ に なる て しまう わけ だ	それゆえに、もしふたりの娘が嫁いでしまえば、うま味が少しだけになってしまうわけだ
ひとり だけ でも 深刻 だ ほど に 損なう れる	ひとりだけでも深刻なほどに損なわれる
今朝 の 仕事 は 無駄 だ は ない た	今朝の仕事は無駄ではなかった
この よう だ こと を しでかす 最も 有力 だ 動機 が ある と 証明 する れる た	このようなことをしでかす最も有力な動機があると証明された
さあ 、 ワトソン 、 じっと する て いる 場合 で は ない	さあ、ワトソン、じっとしている場合ではない
とりわけ あの 老人 は 僕 等 が 事 の 邪魔 に なる と 分かる て いる	とりわけあの老人は僕等が事の邪魔になると分かっている
準備 次第 、 辻 馬車 を 呼ぶ で ウォータルー駅 へ 急ぐ う	準備次第、辻馬車を呼んでウォータルー駅へ急ごう
リヴォルヴァ を 懐 に 忍ぶ せる て くれる と ありがたい	リヴォルヴァを懐に忍ばせてくれるとありがたい
エリィ ＮＯ ． ２ だ 、 鉄 の 火 掻く 棒 を 折る 紳士 に も うまい 対抗 できる	エリィＮＯ．２なら、鉄の火掻き棒を折る紳士にもうまく対抗できる
それと 歯ブラシ 、 それ だけ で 足りる だ う	それと歯ブラシ、それだけで足りるだろう
ウォータルー駅 で 運 よい レザヘッド駅 行き の 汽車 を 捕まえる 、 そこ から 駅 付き の 宿屋 で 軽 馬車 を 頼む 、 美しい サリィ州 の 田舎道 を 四 、 五 マイル ほど 揺る れる て いく た	ウォータルー駅で運よくレザヘッド駅行きの汽車を捕まえ、そこから駅付きの宿屋で軽馬車を頼み、美しいサリィ州の田舎道を四、五マイルほど揺られていった
申し分 の ない 天気 で 、 日 はうら ら か 、 空 に は ふわふわ する た 雲	申し分のない天気で、日はうららか、空にはふわふわした雲
沿道 の 木々 に も 生け垣 に も 新緑 の 若葉 が 芽生える 、 空気 は 湿る た 土 の 香り を 含む で いる た	沿道の木々にも生け垣にも新緑の若葉が芽生え、空気は湿った土の香りを含んでいた
春 の さわやか だ 希望 と 、 我々 の 取り組む 重い 使命 と の あいだ に 、 私 は 妙 だ 対比 を 感じる ぬ に いる られる ない た	春のさわやかな希望と、我々の取り組む重い使命とのあいだに、私は妙な対比を感じずにいられなかった
我が 友人 は 馬車 の 前 席 で 腕組み を する て 、 帽子 を 深い かぶる 、 あご を 胸 に つける て 、 深い 考え に 沈む で いる た	我が友人は馬車の前席で腕組みをして、帽子を深くかぶり、あごを胸につけて、深い考えに沈んでいた
ところが ふと 身 を 起こす と 、 私 の 肩 を 叩く 、 牧場 の 彼方 を 指さす た	ところがふと身を起こすと、私の肩を叩き、牧場の彼方を指さした
あれ を 見る た ま え	あれを見たまえ
立木 の 多い 庭園 が 緩やか だ 丘 に 沿う て 広がる 、 頂上 は 深い 緑 に 覆う れる た 森 に なる て いる た	立木の多い庭園が緩やかな丘に沿って広がり、頂上は深い緑に覆われた森になっていた
その 木々 の 間 から 、 古屋敷 の 灰色 の 破風 と 高い 屋根 が のぞく て いる た	その木々の間から、古屋敷の灰色の破風と高い屋根がのぞいていた
ストーク・モラン か	ストーク・モランか
と シャーロック・ホームズ が 訊ねる と 、	とホームズが訊ねると、
そう で ごぜ える ます	そうでごぜえます
グリムズビ・ロイロット 博士 の お 屋敷 で がする	グリムズビ・ロイロット博士のお屋敷でがす
と 、 御者 が 答える た	と、御者が答えた
そこで 普請 を やる て いる と か	そこで普請をやっているとか
と シャーロック・ホームズ	とホームズ
そこ が 行く 先 だ	そこが行き先だ
あすこ が 村 で	あすこが村で
御者 は 左手 奥 の 集落 を 指さす た	御者は左手奥の集落を指さした
けども 、 お 屋敷 に 行く なさる だ 、 そこ の 石段 を 上がる て 、 畑 の 小道 を 行く っす ゃるのが 近道 です ぜ	けども、お屋敷に行きなさるなら、そこの石段を上がって、畑の小道を行かっしゃるのが近道ですぜ
ほんら 、 あの 娘 っ子 も 歩く て おる ます う が な	ほんら、あの娘っ子も歩いておりましょうがな
その 娘 っ子 、 どうやら ヘレン・ストーナ さん だ	その娘っ子、どうやらストーナさんだ
シャーロック・ホームズ は 小手 を かざす て 眺める	ホームズは小手をかざして眺める
結構	結構
君 の 言う まま が 賢明 の よう だ	君の言うままが賢明のようだ
我々 は 馬車 を 降りる 、 代金 を 払う と 、 馬車 は レザヘッド の 方 へ がた ごと と 引き返す て いく た	我々は馬車を降り、代金を払うと、馬車はレザヘッドの方へがたごとと引き返していった
この 方 が いい	この方がいい
踏み越す 段 を 上る ながら シャーロック・ホームズ が 言う	踏み越し段を上りながらホームズが言う
建築 技師 やら 、 用事 の ある 人間 が 来る た の だ と 思う に 相違 ない	建築技師やら、用事のある人間が来たのだと思うに相違ない
角 も 立つ ぬ	角も立たぬ
ごきげんよう 、 ヘレン・ストーナ さん	ごきげんよう、ストーナさん
お 約束 通る 参る ます た	お約束通り参りました
今朝 の 依頼 人 は 駆け寄る て 挨拶 する た	今朝の依頼人は駆け寄って挨拶した
顔 に うれしい さ が にじみ出る て いる	顔にうれしさがにじみ出ている
たいへん お待ち 申し上げる ます た	たいへんお待ち申し上げました
声 を 張り上げる 、 熱烈 に 握手 を する	声を張り上げ、熱烈に握手をする
グリムズビ・ロイロット 博士 も ロンドン へ 出る ます た から 、 夕方 まで めった に 帰る て くる ます ん	ロイロット博士もロンドンへ出ましたから、夕方までめったに帰ってきません
先生 と は 、 もう お 近づく の 光栄 を いただく ます た	先生とは、もうお近づきの光栄をいただきました
と シャーロック・ホームズ は 言う 、 起こる た 事 を 手短 に 説明 する た	とホームズは言い、起こった事を手短に説明した
ヘレン・ストーナ 嬢 は 終わる まで 聞く ぬ うち に 唇 まで 真っ青 に なる た	ストーナ嬢は終わりまで聞かぬうちに唇まで真っ青になった
なんと いう こと です う	なんということでしょう
あと を つける られる た の です ね	あとをつけられたのですね
その よう だ	そのようで
先読み する れる て 、 いつも 籠 の 中 の 鳥	先読みされて、いつも籠の中の鳥
帰る て くる た 、 何 と 言う れる か	帰ってきたら、何と言われるか
だが 用心 する べし は 向こう の 方 です	だが用心すべきは向こうの方です
もっと 先 を 読む 人間 が 自分 を 追う て いる の です から	もっと先を読む人間が自分を追っているのですから
とにかく 今夜 、 鍵 を 閉める て 彼 を 近づける ぬ こと	とにかく今夜、鍵を閉めて彼を近づけぬこと
狼藉 を 働く よう だ 、 ハロウ の 叔母さん の ところ まで 送る て 差し上げる ます	狼藉を働くようなら、ハロウの叔母さんのところまで送って差し上げます
さて 、 できるだけ 時間 を 有効 に 使う ます う	さて、できるだけ時間を有効に使いましょう
見る て おく べし 部屋 の 方 へ ご 案内 を お願い する ます	見ておくべき部屋の方へご案内をお願いします
建物 は 、 苔むす た 石造り で 、 地 は 灰色 、 中央 部 が 一段と 高い なる て おる 、 それから 左右 へ 棟 が それぞれ 翼状 に のびる て いる た	建物は、苔むした石造りで、地は灰色、中央部が一段と高くなっており、それから左右へ棟がそれぞれ翼状にのびていた
一方 は 窓 の 破れる た ところ に 板 が 打ち付ける て ある たり 、 屋根 が へこむ で いる たり する て 、 廃墟 の 体 だ ある た	一方は窓の破れたところに板が打ち付けてあったり、屋根がへこんでいたりして、廃墟の体であった
中央 部 も 手入れ 不足 だ ある た	中央部も手入れ不足であった
ただ 右側 の 棟 だけ は 、 割合 に 新しい 、 窓 に 日 よ け も ある ば 、 煙突 から は 青い 煙 が ゆらゆら 上る て おる 、 住居 区 だ ある こと が 見て取れる た	ただ右側の棟だけは、割合に新しく、窓に日よけもあれば、煙突からは青い煙がゆらゆら上っており、住居区であることが見て取れた
右側 の 棟 の 外れ に 足場 が くむ で ある 、 石 の 壁 が 崩れる て いる た が 、 我々 が 訪れる た とき 、 職人 の 姿 は どこ に も 見える ない た	右側の棟の外れに足場がくんであり、石の壁が崩れていたが、我々が訪れたとき、職人の姿はどこにも見えなかった
シャーロック・ホームズ は 手入れ の 行き届く て いる ない 芝 地 を ゆっくり と 歩き回る 、 窓 を 外側 から つぶさに 調べる た	ホームズは手入れの行き届いていない芝地をゆっくりと歩き回り、窓を外側からつぶさに調べた
見る た ところ 、 この 端 の 部屋 が が あなた が いつも お 休み に なる 部屋 、 真ん中 が お 姉 様 の 寝室 、 それから 母屋 に 一番 近い の が グリムズビ・ロイロット 博士 の 部屋	見たところ、この端の部屋ががあなたがいつもお休みになる部屋、真ん中がお姉様の寝室、それから母屋に一番近いのがロイロット博士の部屋
その 通り です	その通りです
今 、 わたくし は この 真ん中 で 休む で おる ます が	今、わたくしはこの真ん中で休んでおりますが
改修 中 は 、 です ね	改修中は、ですね
ところで あの 端 の 壁 、 大急ぎ で 直す ほど の もの に は 見える ます ん が	ところであの端の壁、大急ぎで直すほどのものには見えませんが
必要 ない ん です	必要ないんです
わたくし を 部屋 から 追い出す 口実 か と	わたくしを部屋から追い出す口実かと
ほう 、 いわく ある げ で	ほう、いわくありげで
この 細い 棟 の 反対 側 に は 廊下 が ある て 、 三つ の 寝室 が 面す て いる	この細い棟の反対側には廊下があって、三つの寝室が面している
廊下 に 向く た 窓 は ある ます ね	廊下に向いた窓はありますね
ええ 、 ごく 小さい もの が	ええ、ごく小さいものが
狭い ので 、 人 の 通り抜ける は できる ます ん	狭いので、人の通り抜けはできません
夜 、 寝室 に 鍵 が かける て ある ば 、 そちら から は 忍び込める ない	夜、寝室に鍵がかけてあれば、そちらからは忍び込めない
では 、 真ん中 の 部屋 へ お 入り に なる て 中 から 鎧戸 を 閉める 、 閂 を かける て みる て くださる	では、真ん中の部屋へお入りになって中から鎧戸を閉め、閂をかけてみてください
ヘレン・ストーナ 嬢 は 指示 に 従う た	ストーナ嬢は指示に従った
シャーロック・ホームズ は 開く た 窓 も 念入り に 調べる て から 、 外 から 鎧戸 を 無理 に こじ開ける う と 手 を 尽くす た	ホームズは開いた窓も念入りに調べてから、外から鎧戸を無理にこじ開けようと手を尽くした
が 、 うまい いく ない た	が、うまくいかなかった
中 の 閂 を はずす う として も 、 ナイフ の 刃 を 差し込む 隙間 が ない	中の閂をはずそうとしても、ナイフの刃を差し込む隙間がない
そこで 拡大鏡 を 出す て 蝶番 を 調べる て みる た が 、 その 蝶番 は 頑丈 だ 鉄製 で 、 固い 石壁 に しっかり 埋め込む で ある た	そこで拡大鏡を出して蝶番を調べてみたが、その蝶番は頑丈な鉄製で、固い石壁にしっかり埋め込んであった
ふむ	ふむ
と シャーロック・ホームズ も 困る た という 風 に あご を さする 、 僕 の 理論 に は まずい ところ が ある らしい	とホームズも困ったという風にあごをさすり、僕の理論にはまずいところがあるらしい
閂 が かかる て いる ば 誰 も 鎧戸 を 通れる ぬ か	閂がかかっていれば誰も鎧戸を通れぬか
ふむ 、 内部 に 何 か 事件 の 手がかり が ない か 調べる う	ふむ、内部に何か事件の手がかりがないか調べよう
横 に ある 小さな 戸 を 押す と 、 三つ の 寝室 が 並ぶ 白壁 の 廊下 に 出る た	横にある小さな戸を押すと、三つの寝室が並ぶ白壁の廊下に出た
シャーロック・ホームズ は 三 番目 の 部屋 を 見る ぬ に すぐさま 二 番目 の 部屋 、 すなわち 今 ヘレン・ストーナ 嬢 が 使う 、 彼女 の 姉 が 最期 を 遂げる た 部屋 に 向かう た	ホームズは三番目の部屋を見ずにすぐさま二番目の部屋、すなわち今ストーナ嬢が使い、彼女の姉が最期を遂げた部屋に向かった
質素 だ 小さい 部屋 で 、 低い 天井 、 大きい 暖炉 、 いかにも 田舎 屋敷 風 だ ある	質素な小さい部屋で、低い天井、大きい暖炉、いかにも田舎屋敷風である
隅 に は 茶色 の 箪笥 が 置く て ある 、 もう 一方 の 隅 は 白い 上 掛け を かぶせる た 寝台 が ある 、 窓 の 左側 に は 化粧 台 が ある た	隅には茶色の箪笥が置いてあり、もう一方の隅は白い上掛けをかぶせた寝台があり、窓の左側には化粧台があった
その ほか 、 小さな 籐椅子 二つ を 加える た の が この 部屋 の 家具 の すべて だ ある た	そのほか、小さな籐椅子二つを加えたのがこの部屋の家具のすべてであった
あと 部屋 の 中央 に 高級 だ ウィルトン 絨毯 が 敷く れる て いる た	あと部屋の中央に高級なウィルトン絨毯が敷かれていた
床 も 壁 も みんな 虫 の 食う た 褐色 の 樫 材 で 、 古い さ と 色あせる を 見る て も この 建物 が できる て 以来 そのまま の もの に 違い ない た	床も壁もみんな虫の食った褐色の樫材で、古さと色あせを見てもこの建物ができて以来そのままのものに違いなかった
シャーロック・ホームズ は 椅子 の 一つ を 一方 の 隅 に 引く て いく て 、 しずか に 腰 を 下ろす と 、 上下 左右 に ぐるり と 目 を やる 、 部屋 の 隅々 まで 見回す た	ホームズは椅子の一つを一方の隅に引いていって、しずかに腰を下ろすと、上下左右にぐるりと目をやり、部屋の隅々まで見回した
あの 呼び鈴 は 、 どこ へ 通じる て いる ます か	あの呼び鈴は、どこへ通じていますか
ふと 、 シャーロック・ホームズ は 寝台 の そば に 垂れ下がる て いる 太い 綱 を 指さす た	ふと、ホームズは寝台のそばに垂れ下がっている太い綱を指さした
枕 の 上 に 房 の 先 が 乗っかる て いる	枕の上に房の先が乗っかっている
家政 婦 の 部屋 へ 通じる て おる ます	家政婦の部屋へ通じております
他 の もの より 真新しい よう です が	他のものより真新しいようですが
ええ 、 二年前 に つける た ばかり です	ええ、二年前につけたばかりです
すると 、 お 姉 さま が つける させる た	すると、お姉さまがつけさせた
いえ 、 その よう だ 話 は	いえ、そのような話は
いつも 自分 の こと は 自分 で 致す ます ので	いつも自分のことは自分で致しますので
では 、 こんな 立派 だ 引き 綱 など 不 必要 です う	では、こんな立派な引き綱など不必要でしょう
床 を 確認 する ます ので 、 もう しばらく お待ち くださる	床を確認しますので、もうしばらくお待ちください
シャーロック・ホームズ は 手 に 拡大鏡 を 持つ 、 頭 を 床 に 近づける た	ホームズは手に拡大鏡を持ち、頭を床に近づけた
床 に は いる つ くばる ながら 前後 に 動く て 、 床板 の 隙間 まで 細かい 調べる た	床にはいつくばりながら前後に動いて、床板の隙間まで細かく調べた
それ が すむ と 壁 の 木材 を 同じ よう に 調べる つくす た	それがすむと壁の木材を同じように調べつくした
そして 寝台 へ 歩み寄る 、 しばらく 見つめる て いる た が 、 壁 を 上 から 下 へ 眺め 回す た	そして寝台へ歩み寄り、しばらく見つめていたが、壁を上から下へ眺め回した
最後 に 呼び鈴 の 引き 綱 を つかむ で 、 思い切り 引っ張る た	最後に呼び鈴の引き綱をつかんで、思い切り引っ張った
おや 、 飾り か	おや、飾りか
鳴る ます ん か	鳴りませんか
ええ 、 針金 に つながる て も いる ない	ええ、針金につながってもいない
実に 面白い	実に面白い
ごらん なさる 、 引き 綱 は 換気 の ため の 小さな 穴 の 上 の あたり で 、 かぎ針 に 結ぶ れる て 動く ない	ごらんなさい、引き綱は換気のための小さな穴の上のあたりで、かぎ針に結ばれて動かない
訳 が わかる ます ん	訳がわかりません
今 まで ちっとも 気づく ます ん です た	今までちっとも気づきませんでした
実に 妙 だ	実に妙だ
と 、 シャーロック・ホームズ は つぶやく 、 綱 を 引っ張る	と、ホームズはつぶやき、綱を引っ張る
この 部屋 に は 、 奇妙 だ 点 が いくつ か ある ます	この部屋には、奇妙な点がいくつかあります
たとえば 、 大工 は いったい 何 を 考える て 、 隣 の 部屋 へ 穴 を あける の か	たとえば、大工はいったい何を考えて、隣の部屋へ穴をあけるのか
通風 口 だ 、 外気 が 入る よう に する はず です	通風口なら、外気が入るようにするはずです
それ も 最近 の もの だ ござる ます	それも最近のものでございます
引き 綱 と 同じ 頃 です か	引き綱と同じ頃ですか
ええ 、 その ほか に も 少し 直す た ところ が いくつ も ござる ます	ええ、そのほかにも少し直したところがいくつもございます
非常 に 興味深い 特徴 が ある よう です —— 飾り だけ の 引き 綱 、 風 の 入る ない 通風 口	非常に興味深い特徴があるようです——飾りだけの引き綱、風の入らない通風口
よろしい です ね 、 ヘレン・ストーナ さん 、 もう ひとつ 内側 の 部屋 を 調べ に 参る ます う	よろしいですね、ストーナさん、もうひとつ内側の部屋を調べに参りましょう
グリムズビ・ロイロット 博士 の 寝室 は 、 娘 たち の 部屋 より 広い た が 、 家具 は 同様 に 質素 だ もの だ た	グリムズビ・ロイロット博士の寝室は、娘たちの部屋より広かったが、家具は同様に質素なものだった
折りたたみ の できる 寝台 、 医学 書 ばかり 詰まる た 木製 の 本棚 、 寝台 の わき に 肘掛 椅子 が 一つ 、 壁 に 寄せる て 粗末 だ 椅子 が 一つ 、 円卓 が 一つ 、 それ から 大きい 金庫 、 これら が 目 に とまる 主立つ た もの だ ある	折りたたみのできる寝台、医学書ばかり詰まった木製の本棚、寝台のわきに肘掛椅子が一つ、壁に寄せて粗末な椅子が一つ、円卓が一つ、それから大きい金庫、これらが目にとまる主立ったものである
シャーロック・ホームズ は 歩き回る て 、 それら を いちいち 強い 関心 を 持つ て 調べる て いく た	ホームズは歩き回って、それらをいちいち強い関心を持って調べていった
中 に は 何 が	中には何が
と 、 シャーロック・ホームズ は 金庫 を 軽い 叩く た	と、ホームズは金庫を軽く叩いた
個人 的 だ 書類 です	個人的な書類です
ほう 、 中 を ごらん に	ほう、中をごらんに
一度 、 何 年 か 前 に	一度、何年か前に
中 に は 書類 が ぎっしり と	中には書類がぎっしりと
中 に 猫 が いる 、 と か	中に猫がいる、とか
いえ 、 滅相 も ない	いえ、滅相もない
しかし 、 ごらん なさる	しかし、ごらんなさい
と 、 シャーロック・ホームズ は 金庫 の 上 から 牛乳 の 入る た 小皿 を 下ろす て みせる た	と、ホームズは金庫の上から牛乳の入った小皿を下ろしてみせた
でも 、 うち に 猫 は おりる ます ん	でも、うちに猫はおりません
豹 と ヒヒ は おりる ます けれど … …	豹とヒヒはおりますけれど……
ええ 、 存じる て おる ます	ええ、存じております
まあ 、 豹 は 大きな 猫 と も 言える ます う が 、 まさか こんな 小皿 で 満足 する はず も ない	まあ、豹は大きな猫とも言えましょうが、まさかこんな小皿で満足するはずもない
考える こと が 一つ 増える ます た	考えることが一つ増えました
それから シャーロック・ホームズ は 木 の 椅子 の 前 に しゃがむ で 、 背 の 部分 を 念入り に 調べる た	それからホームズは木の椅子の前にしゃがんで、背の部分を念入りに調べた
感謝 する ます	感謝します
はっきり する て くる ます た	はっきりしてきました
と 、 シャーロック・ホームズ は 立ち上がる 、 拡大鏡 を 懐 に しまう ながら 、 おや 、 これ は 面妖 だ	と、ホームズは立ち上がり、拡大鏡を懐にしまいながら、おや、これは面妖な
シャーロック・ホームズ の 目 を とらえる た の は 、 寝台 の 角 に かける て ある た 小さな 犬 鞭 だ ある た	ホームズの目をとらえたのは、寝台の角にかけてあった小さな犬鞭であった
ただし その 鞭 の 先 は 、 丸い 輪 に する て 結ぶ で ある た	ただしその鞭の先は、丸く輪にして結んであった
これ を どう 思う ね 、 ワトソン	これをどう思うね、ワトソン
ごく 普通 の 鞭 か ね 、 なぜ 輪 に なる て いる の だ う	ごく普通の鞭かね、なぜ輪になっているのだろう
普通 どころ だ は ない	普通どころではない
まったく	まったく
世 も 末 だ	世も末だ
知恵 の ある 人間 が 悪事 の ため に 頭 を 使う と は 、 末恐ろしい	知恵のある人間が悪事のために頭を使うとは、末恐ろしい
じゅうぶん 見せる て いただく ます た 、 ヘレン・ストーナ さん	じゅうぶん見せていただきました、ストーナさん
よろしい ば 、 芝 地 の 方 へ 出る ます う	よろしければ、芝地の方へ出ましょう
我が 友人 は 今 まで に ない ほど きつい 顔 を しかめる 、 眉根 を 寄せる た	我が友人は今までにないほどきつく顔をしかめ、眉根を寄せた
それ は ちょうど 事件 の 現場 を 離れる た とき だ た	それはちょうど事件の現場を離れたときだった
三 人 が うち 連れ だって 芝 地 を 何 度 も 行う たり 来る たり する た が 、 ヘレン・ストーナ 嬢 も 私 も 、 シャーロック・ホームズ の 考え の 邪魔 を する ぬ よう に 、 ひとしきり 終わる まで 待つ た	三人がうち連れだって芝地を何度も行ったり来たりしたが、ストーナ嬢も私も、ホームズの考えの邪魔をせぬように、ひとしきり終わるまで待った
お話 が ある ます 、 ヘレン・ストーナ さん	お話があります、ストーナさん
シャーロック・ホームズ が 言う	ホームズが言う
どう ある う と 、 僕 の 言う とおり に する こと です	どうあろうと、僕の言うとおりにすることです
きっと そう いたす ます	きっとそういたします
事態 は 切迫 する て おる ます	事態は切迫しております
守る て いただく ない て は 、 命 の 保証 は できる ます ん	守っていただかなくては、命の保証はできません
わたくし の 身 は 、 お 委ねる いたす ます	わたくしの身は、お委ねいたします
まず 第 一 に 、 僕ら 二 人 は 、 あなた の 部屋 で 夜 を 明かす ぬ ば なる ます ん	まず第一に、僕ら二人は、あなたの部屋で夜を明かさねばなりません
ヘレン・ストーナ 嬢 も 私 も 、 驚き の 目 で シャーロック・ホームズ を 見つめる た	ストーナ嬢も私も、驚きの目でホームズを見つめた
これ は 絶対 です	これは絶対です
説明 する ます	説明します
あそこ に 見える の は 、 村 の 宿屋 です ね	あそこに見えるのは、村の宿屋ですね
ええ 、 クラウン と 申す ます	ええ、クラウンと申します
結構	結構
あそこ から あなた の お 部屋 の 窓 が 見える ます ね	あそこからあなたのお部屋の窓が見えますね
はっきり と	はっきりと
父親 が 帰る て くる た 、 あなた は 頭 が 痛い と 言う て 、 ご 自分 の 部屋 へ 下がる て くださる	父親が帰ってきたら、あなたは頭が痛いと言って、ご自分の部屋へ下がってください
それから 父親 が 夜 、 部屋 に 引き取る 音 が 聞こえる た 、 あなた は 窓 の 鎧戸 を 開く 、 掛け金 を 外す て 、 そこ から ランプ で 僕ら に 合図 する て くださる	それから父親が夜、部屋に引き取る音が聞こえたら、あなたは窓の鎧戸を開き、掛け金を外して、そこからランプで僕らに合図してください
そう する て おく て 、 あなた は 静か に 必要 だ もの を 手 に する て 部屋 を お 出 に なる 、 元 使う て おる れる た 部屋 へ	そうしておいて、あなたは静かに必要なものを手にして部屋をお出になり、元使っておられた部屋へ
壁 に 穴 が 開く て いる ます が 、 一 晩 だ 何とか 我慢 する て いただける か と	壁に穴が開いていますが、一晩なら何とか我慢していただけるかと
え 、 ええ 、 大丈夫 です	え、ええ、大丈夫です
あと は 、 僕ら に お 任せる くださる	あとは、僕らにお任せください
その 、 どう なさる の です か	その、どうなさるのですか
僕ら は 、 あなた の 部屋 で 一夜 を 明かす 、 あなた がた を 悩ます た 音 の 正体 を 突き止める ます	僕らは、あなたの部屋で一夜を明かし、あなたがたを悩ました音の正体を突き止めます
では 、 シャーロック・ホームズ さん 、 すでに 見当 が 付く て いらっしゃる の です ね	では、ホームズさん、すでに見当が付いていらっしゃるのですね
ヘレン・ストーナ 嬢 は 、 シャーロック・ホームズ の 服 の 袖 に 手 を かける	ストーナ嬢は、ホームズの服の袖に手をかける
おそらくは	おそらくは
です た お願い です	でしたらお願いです
姉 の 死因 は 何 だ ござる ます う	姉の死因は何でございましょう
申し上げる より 、 確固 と する た 証拠 を つかむ の が 先 です	申し上げるより、確固とした証拠をつかむのが先です
せめて わたくし の 考え が 合う て いる の か どう か を	せめてわたくしの考えが合っているのかどうかを
姉 は 恐怖 の あまり 亡くなる た の です か	姉は恐怖のあまり亡くなったのですか
いや 、 違う です う	いや、違うでしょう
より 判然 と する た 原因 が ある か と	より判然とした原因があるかと
それでは ヘレン・ストーナ さん 、 お 暇 いたす ます	それではストーナさん、お暇いたします
グリムズビ・ロイロット 博士 が 帰る て くる て 、 僕ら が ここ に いる と 知れる て は 台無し です	ロイロット博士が帰ってきて、僕らがここにいると知れては台無しです
失礼 する ます 、 気 を 強い お 持つ に	失礼します、気を強くお持ちに
言葉 通り に する て いただける ば 、 迫る くる 危険 は すぐ に 取り除く れる 、 安心 できる よう に なる ます ので	言葉通りにしていただければ、迫りくる危険はすぐに取り除かれ、安心できるようになりますので
シャーロック・ホームズ と 私 は 、 宿屋 クラウン ・ イン で 、 居間 つき の 寝室 を 難なく 手配 できる た	シャーロック・ホームズと私は、宿屋クラウン・インで、居間つきの寝室を難なく手配できた
我々 は 二 階 に 陣取る 、 窓 から は ストーク・モラン の 領主 館 が 、 門 から 道 、 住居 棟 に いたる まで 見通す こと が できる た	我々は二階に陣取り、窓からはストーク・モランの領主館が、門から道、住居棟にいたるまで見通すことができた
夕暮れ 時 、 グリムズビ・ロイロット 博士 が 馬車 で 帰宅 する の が 見える た	夕暮れ時、グリムズビ・ロイロット博士が馬車で帰宅するのが見えた
御者 の 少年 の 小さい さ に 比べる て 、 その 巨体 は 覆う よう だ ある	御者の少年の小ささに比べて、その巨体は覆うようである
少年 が 重い 鉄 門 を 開ける かねる て いる と 、 博士 の 荒々しい 怒鳴る 声 が 聞こえる 、 怒る て 握り拳 を 振り回す て いる の も 見える た	少年が重い鉄門を開けかねていると、博士の荒々しい怒鳴り声が聞こえ、怒って握り拳を振り回しているのも見えた
馬車 が 走り 帰る て 数 分の 後 、 居間 の 一つ に ランプ が 灯す れる 、 木立 を 縫う て ぱっと 黄色い 光 が 漏れる だす た	馬車が走り帰って数分の後、居間の一つにランプが灯され、木立を縫ってぱっと黄色い光が漏れだした
いい かい 、 ワトソン	いいかい、ワトソン
と 、 シャーロック・ホームズ が 言う	と、ホームズが言う
我々 は 暮れる ゆく なか 、 椅子 に 腰掛ける て いる た	我々は暮れゆくなか、椅子に腰掛けていた
今晩 、 君 を 連れる て ゆく か 実は ためらう て いる	今晩、君を連れてゆくか実はためらっている
危険 が 目 に 見える て いる	危険が目に見えている
私 は お 邪魔 か ね	私はお邪魔かね
来る て くれる と どんなに 助かる か	来てくれるとどんなに助かるか
なら 、 行く で 決まり だ	なら、行くで決まりだ
実に ありがたい	実にありがたい
危険 と 言う が 、 私 は あの 部屋 で 何 か 見逃す た の だ う か	危険と言うが、私はあの部屋で何か見逃したのだろうか
いや	いや
ただし 僕 は 若干 推理 を する た	ただし僕は若干推理をした
見る た もの は 君 と 変わる ない と 思う	見たものは君と変わりないと思う
私 が 妙 だ と 思う た の は 、 引き 綱 くらい だ	私が妙だと思ったのは、引き綱くらいだ
正直 、 何 の ため に あんな こと を する た の か 、 見当 も 付く ん	正直、何のためにあんなことをしたのか、見当も付かん
通風 口 も 見る た ね	通風口も見たね
ああ	ああ
部屋 の あいだ に 小さな 穴 が ある の は 不自然 だ と も 思える ん が	部屋のあいだに小さな穴があるのは不自然だとも思えんが
しかも 小さい て ネズミ 一 匹 通れる ん よ	しかも小さくてネズミ一匹通れんよ
ストーク・モラン へ 来る 前 から 、 通風 口 が ある だ う と 踏む で いる た	ストーク・モランへ来る前から、通風口があるだろうと踏んでいた
おいおいホームズ	おいおいホームズ
ああ 、 本気 だ	ああ、本気だ
思い出す て みる た まえる 、 お嬢さん の 話 で は 、 姉 が グリムズビ・ロイロット 博士 の 煙草 が 匂う と	思い出してみたまえ、お嬢さんの話では、姉がロイロット博士の煙草が匂うと
とすれば 当然 、 二つ の 部屋 が 通じる て いる はず 、 と すぐ 分かる	とすれば当然、二つの部屋が通じているはず、とすぐ分かる
かなり 小さい もの に 違い ない	かなり小さいものに違いない
さも ない ば 、 検視 官 が 調べる た とき 気づく て いる た はず だ	さもなくば、検視官が調べたとき気づいていたはずだ
よって 通風 口 という 答え が 導く れる	よって通風口という答えが導かれる
だが 、 あれ が 何 の 害 に なる	だが、あれが何の害になる
少なくとも 時期 が 奇妙 に 一致 する て いる	少なくとも時期が奇妙に一致している
通風 口 が 作る れる 、 引き 綱 が つるす れる 、 寝台 に 寝る て いる た 女性 が 亡くなる	通風口が作られ、引き綱がつるされ、寝台に寝ていた女性が亡くなる
何 か に 気が付く ない か	何かに気が付かないか
どんな つながり が ある ん だ ね	どんなつながりがあるんだね
あの 寝台 に 妙 だ ところ は ない た か	あの寝台に妙なところはなかったか
別に	別に
床 に 金具 で 固定 する て ある	床に金具で固定してある
そんな 寝台 どこ に ある	そんな寝台どこにある
どこ に も ない	どこにもない
ご 婦人 は 寝台 を 動く せる ない た	ご婦人は寝台を動かせなかった
いつも 同じ 位置 関係 だ た ん だ 、 通風 口 と 綱 に対して —— そう 、 ただ の 綱 と 呼ぶ う	いつも同じ位置関係だったんだ、通風口と綱に対して——そう、ただの綱と呼ぼう
引く て も 鳴る ない の だ から	引いても鳴らないのだから
シャーロック・ホームズ	ホームズ
と 私 は 声 を 張る	と私は声を張る
君 の 言う ん と する こと が おぼろ げ に 分かる て くる た	君の言わんとすることがおぼろげに分かってきた
我々 は 、 その 巧妙 だ 恐る べし 犯罪 を 瀬戸際 で 食い止める という わけ だ な	我々は、その巧妙で恐るべき犯罪を瀬戸際で食い止めるというわけだな
巧妙 だ 恐ろしい … … そう だ ね	巧妙で恐ろしい……そうだね
医師 が 悪事 を 行う ば 、 一流 の 犯罪 者 に なる	医師が悪事を行えば、一流の犯罪者になる
パーマ や プリチャド は その 筆頭 だ	パーマやプリチャドはその筆頭だ
今回 の 相手 は その 上 を 行く が 、 ワトソン 、 しかし 僕ら は その さらに 上 を 行く	今回の相手はその上を行くが、ワトソン、しかし僕らはそのさらに上を行く
ともかく 、 夜 が 終わる まで 気 は 抜ける ない	ともかく、夜が終わるまで気は抜けない
せめて この 二 、 三 時間 は 、 静か に パイプ で も くわえる ながら 気分 転換 で も する う	せめてこの二、三時間は、静かにパイプでもくわえながら気分転換でもしよう
九時 頃 、 木立 から 漏れる て いる た 明かり が 消える て 、 ストーク・モラン の 方向 は 闇 に 包む れる た	九時頃、木立から漏れていた明かりが消えて、ストーク・モランの方向は闇に包まれた
二 時間 が 静か に 過ぎる 、 そして 時計 が 十 一 時 を 打つ と 同時に 、 ふと 、 正面 右 の 方 に 、 合図 の 明かり が 灯す れる た	二時間が静かに過ぎ、そして時計が十一時を打つと同時に、ふと、正面右の方に、合図の明かりが灯された
合図 か	合図か
シャーロック・ホームズ が 立ち上がる	ホームズが立ち上がる
真ん中 の 窓 だ	真ん中の窓だ
出かける に シャーロック・ホームズ は 宿 の 主人 と 言葉 を 交わす 、 これから 知人 を 訪問 する が 都合 によって は 向こう に 泊まる かも しれる ない 、 と 告げる た	出かけにホームズは宿の主人と言葉を交わし、これから知人を訪問するが都合によっては向こうに泊まるかもしれない、と告げた
しばらく する と 暗い 道 に 出る て 、 冷たい 風 が さっと 頬 を なでる	しばらくすると暗い道に出て、冷たい風がさっと頬をなでる
前方 の 闇 の 中 に は 、 黄色い 灯 が 木立 を 抜ける て 、 我々 を 不気味 だ 使命 へ と 導く	前方の闇の中には、黄色い灯が木立を抜けて、我々を不気味な使命へと導く
庭 の 塀 が 崩れる て いる た ので 、 難なく 敷地 の 中 へ 入れる た	庭の塀が崩れていたので、難なく敷地の中へ入れた
木々 の あいだ を かいくぐる と 芝 地 に 出る た	木々のあいだをかいくぐると芝地に出た
通り過ぎる て 窓 から 中 へ 入ろう と する た とき 、 突然 、 月桂樹 の 茂み の 中 から おぞましい 怪物 の よう だ もの が 飛び出す 、 草 の 上 を 転がる た 後 、 そのまま 芝 地 を 通り過ぎる て 闇 の 中 へ 駆け込む で しまう た	通り過ぎて窓から中へ入ろうとしたとき、突然、月桂樹の茂みの中からおぞましい怪物のようなものが飛び出し、草の上を転がった後、そのまま芝地を通り過ぎて闇の中へ駆け込んでしまった
なんと	なんと
私 は 息 を 呑む	私は息を呑む
見る た か 今 の	見たか今の
シャーロック・ホームズ も その とき は 動揺 する た らしい 、 私 の 手 を ぎゅっと 握りしめる た が 、 すぐ と 忍び笑い を はじめて 、 私 に 耳打ち する た	ホームズもそのときは動揺したらしく、私の手をぎゅっと握りしめたが、すぐと忍び笑いをはじめて、私に耳打ちした
結構 だ 家族 だ	結構な家族だ
と シャーロック・ホームズ は つぶやく	とホームズはつぶやく
ヒヒ だ よ	ヒヒだよ
博士 の かわいがる て いる た 奇妙 だ ペット の こと を ど 忘れる する て いる た	博士のかわいがっていた奇妙なペットのことをど忘れしていた
豹 も いる	豹もいる
ひょっと する と 、 次 の 瞬間 に は そいつ が 肩 に かみつく て いる かも しれる ない の だ	ひょっとすると、次の瞬間にはそいつが肩にかみついているかもしれないのだ
シャーロック・ホームズ の 真似 を する て 靴 を 脱ぐ 、 窓 から 寝室 へ 入り込む だ とき 、 正直 ほっと する た	ホームズの真似をして靴を脱ぎ、窓から寝室へ入り込んだとき、正直ほっとした
我が 友人 は 音 を 立てる ぬ よう 鎧戸 を 閉める 、 ランプ を 卓上 に 移す て 、 部屋 の 中 を 見渡す た	我が友人は音を立てぬよう鎧戸を閉め、ランプを卓上に移して、部屋の中を見渡した
昼間 見る た とき と 変わる は ない	昼間見たときと変わりはない
それから シャーロック・ホームズ は 私 の そば へ 忍び寄る 、 両手 で トランペット を こしらえる 、 私 の 耳 に やっと 聞こえる ほど の 小さい 声 で ささやく た	それからホームズは私のそばへ忍び寄り、両手でトランペットをこしらえ、私の耳にやっと聞こえるほどの小さい声でささやいた
かすか だ 物音 が 計画 を 台無し に する	かすかな物音が計画を台無しにする
分かる た と 私 は うなずく	分かったと私はうなずく
明かり を 消す て 、 じっと する	明かりを消して、じっとする
通風 口 から 漏れる て 、 さとる れる お それ が	通風口から漏れて、さとられるおそれが
もう一度 うなずく	もう一度うなずく
眠る の も ない だ	眠るのもなしだ
君 の 命 に 関わる	君の命に関わる
いつ でも 使える よう 君 の 拳銃 も 準備 を	いつでも使えるよう君の拳銃も準備を
僕 は 寝台 の へる に 座る から 、 君 は そっち の 椅子 へ	僕は寝台のへりに座るから、君はそっちの椅子へ
私 は リヴォルヴァ を 出す て 、 机 の 隅 に そっと 置く た	私はリヴォルヴァを出して、机の隅にそっと置いた
シャーロック・ホームズ は 持つ て くる た 細い 長い 杖 を 寝台 に 立てかける た	ホームズは持ってきた細く長い杖を寝台に立てかけた
その そば に マッチ の 箱 と 燃えさし の 蝋燭 を 並べる た	そのそばにマッチの箱と燃えさしの蝋燭を並べた
それから ランプ の 明かり を 消す 、 我々 は 闇 に 包む れる た	それからランプの明かりを消し、我々は闇に包まれた
眠る こと ない 過ごす た あの 夜 の こと を 、 終生 忘れる こと は ない	眠ることなく過ごしたあの夜のことを、終生忘れることはない
息 を 殺す と 、 音 一つ ない	息を殺すと、音一つない
我が 友人 は 数 歩 先 で 目 を 見開く 、 座る て いる はず だ のに	我が友人は数歩先で目を見開き、座っているはずなのに
私 と 同じ よう に 気 を 張りつめる て いる はず だ のに	私と同じように気を張りつめているはずなのに
鎧戸 が 、 ほんの わずか だ 光 さえ も 遮る 、 我々 は 絶対 の 闇 に 待つ	鎧戸が、ほんのわずかな光さえも遮り、我々は絶対の闇に待つ
外 から 夜鳥 の 啼く 声 が 時折 、 まさに 目 の 前 の 窓 の ところ で 猫 に 似る た 長い 引く つる た 鳴き声 が 一 度	外から夜鳥の啼く声が時折、まさに目の前の窓のところで猫に似た長く引きつった鳴き声が一度
豹 が 放つ れる た に 相違 ない	豹が放たれたに相違ない
はるか 遠く の 空 で 教会 の 鐘 が おごそか に 響く	はるか遠くの空で教会の鐘がおごそかに響く
十 五 分 ごと に 低い 強い	十五分ごとに低く強く
十 五 分間 が こんなに 長い と は	十五分間がこんなに長いとは
十 二 時 が 打つ れる 、 一 と 二 と 三 と 、 それでも まだ 静か に 座り 待つ 続ける 、 何 か が 起こる の を	十二時が打たれ、一と二と三と、それでもまだ静かに座り待ち続ける、何かが起こるのを
ふと 通風 口 の 方 から 、 一瞬 だけ 光 が 漏れる 、 すぐ 消える	ふと通風口の方から、一瞬だけ光が漏れ、すぐ消える
続く て 油 が 燃える 、 金属 が 熱す られる きつい 匂い	続いて油が燃え、金属が熱せられるきつい匂い
誰 か 隣 の 部屋 で 手提げ 角灯 に 火 を つける た の だ	誰か隣の部屋で手提げ角灯に火をつけたのだ
静か に 人 の 動く 気配 が する	静かに人の動く気配がする
それ も まもなく 静まる 、 あと は ただ きつい 匂い だけ が 残る	それもまもなく静まり、あとはただきつい匂いだけが残る
半 時間 の あいだ 、 耳 を 澄む せる	半時間のあいだ、耳を澄ませる
唐突 に 別 の 物音 が 聞く て くる	唐突に別の物音が聞こてくる
ごく 柔らか だ 、 穏やか だ 、 さやさや と 薬缶 から 湯気 が 噴き出す よう だ 、 かすか だ 音	ごく柔らかな、穏やかな、さやさやと薬缶から湯気が噴き出すような、かすかな音
聞こえる た と 思う や その 刹那 、 シャーロック・ホームズ が 寝台 から 飛び上がる 、 マッチ を 擦る 、 引き 綱 に 手 の 杖 で 一閃 を 食らう せる	聞こえたと思うやその刹那、ホームズが寝台から飛び上がり、マッチを擦り、引き綱に手の杖で一閃を食らわせる
見る た か 、 ワトソン	見たか、ワトソン
シャーロック・ホームズ が 叫ぶ	ホームズが叫ぶ
見る た か	見たか
私 に は 見える ない た	私には見えなかった
シャーロック・ホームズ が マッチ を 擦る た 瞬間 に 、 低い 澄む だ 口笛 は 耳 に する た	ホームズがマッチを擦った瞬間に、低く澄んだ口笛は耳にした
だが 闇 に なれる た 私 の 目 は 、 突然 の 光 の まぶしい さ に 、 シャーロック・ホームズ が 何 を 打ち据える の か 見定める こと が できる ない た	だが闇になれた私の目は、突然の光のまぶしさに、ホームズが何を打ち据えるのか見定めることができなかった
ただ 見える た の は 、 ひどく 青ざめる 、 恐怖 と 嫌悪 に ゆがむ だ シャーロック・ホームズ の 顔 だけ だ	ただ見えたのは、ひどく青ざめ、恐怖と嫌悪にゆがんだホームズの顔だけだ
シャーロック・ホームズ は 打つ の を やめる 、 じっと 通風 口 の 方 を 見上げる て いる た	ホームズは打つのをやめ、じっと通風口の方を見上げていた
その とき 、 夜 の 静けさ を 破る て 、 この世 の もの と 思える ぬ 悲鳴 が 聞こえる て くる た	そのとき、夜の静けさを破って、この世のものと思えぬ悲鳴が聞こえてきた
その 悲鳴 は 徐々に 大きい なる 、 しゃがれる 声 の なか に 、 苦しみ と 恐れ と 怒り が 入り交じる 、 ついに 断末魔 の 叫び と なる	その悲鳴は徐々に大きくなり、しゃがれ声のなかに、苦しみと恐れと怒りが入り交じり、ついに断末魔の叫びとなる
聞く た 話 で は 、 村 を 通り越す て 遠く の 牧師 館 まで 聞こえる 、 人々 の 眠り を 覚ます た という	聞いた話では、村を通り越して遠くの牧師館まで聞こえ、人々の眠りを覚ましたという
我々 も 肝 を 冷やす 、 私 は シャーロック・ホームズ の 顔 を 、 シャーロック・ホームズ は 私 を 見つめる た まま 立ちすくむ だ	我々も肝を冷やし、私はホームズの顔を、ホームズは私を見つめたまま立ちすくんだ
やがて 声 も 消え入る 、 あたり は 元 の 静けさ に 戻る た	やがて声も消え入り、あたりは元の静けさに戻った
何だ 、 今 の は	何だ、今のは
私 は 息 を 呑む だ	私は息を呑んだ
すべて が 終わる た 知らせ だ	すべてが終わった知らせだ
と シャーロック・ホームズ が 答える	とホームズが答える
そう 、 この 結末 が 最善 だ の かも しれる ぬ	そう、この結末が最善なのかもしれぬ
拳銃 を 持つ たまえ	拳銃を持ちたまえ
グリムズビ・ロイロット 博士 の 部屋 へ 行く て みる う	ロイロット博士の部屋へ行ってみよう
深刻 だ 面持ち で ランプ を つける 、 シャーロック・ホームズ は 先 に 立つ て 廊下 を 進む だ	深刻な面持ちでランプをつけ、ホームズは先に立って廊下を進んだ
部屋 の 扉 を 二 度 叩く た が 、 中 から は 何 の 返事 も ない た	部屋の扉を二度叩いたが、中からは何の返事もなかった
取っ手 を 回す て 、 シャーロック・ホームズ は 中 へ 入る	取っ手を回して、ホームズは中へ入る
私 も 後 に 続く た 、 引き金 に 指 を かける つつ	私も後に続いた、引き金に指をかけつつ
私 は 異様 だ 光景 に 目 を 奪う れる た	私は異様な光景に目を奪われた
卓上 に は 、 半分 窓 を 開ける た 角灯 が 置く れる て ある 、 それ から 流れ出る 一 条 の 光 の 中 に 、 戸 の 開く た まま の 金庫 が 見える	卓上には、半分窓を開けた角灯が置かれてあり、それから流れ出る一条の光の中に、戸の開いたままの金庫が見える
机 の わき に ある 木 の 椅子 に 、 グリムズビ・ロイロット 博士 が 、 長い ねずみ色 の 化粧 着 に 身 を 包む 、 つく だす た 素足 に かかと の ない 赤 の トルコ ・ スリッパ を つる かける て 腰 を かける て いる	机のわきにある木の椅子に、グリムズビ・ロイロット博士が、長いねずみ色の化粧着に身を包み、つきだした素足にかかとのない赤のトルコ・スリッパをつっかけて腰をかけている
そして 膝 の 上 に 、 短い 柄 に 長い ひも の つく た 鞭 が ある	そして膝の上に、短い柄に長いひものついた鞭がある
昼間 この 部屋 で 見る た もの だ	昼間この部屋で見たものだ
あご は 上向き だ 、 目 は 強い 見開く れる 、 天井 の 隅 を にらみつける て いる	あごは上向きで、目は強く見開かれ、天井の隅をにらみつけている
額 の 周囲 に は 、 褐色 の 斑 が つく た 黄色い 妙 だ ひも 状 の もの が おる 、 頭 を きつい しめつける て いる た	額の周囲には、褐色の斑がついた黄色い妙なひも状のものがおり、頭をきつくしめつけていた
我々 が 入る た とき に は 、 博士 は 口 も 聞く ぬ 、 身動き も ない た	我々が入ったときには、博士は口も聞かず、身動きもなかった
ひも	ひも
まだ ら の ひも	まだらのひも
と 、 シャーロック・ホームズ は ささやく た	と、ホームズはささやいた
私 は 一 歩 前 に 出る た	私は一歩前に出た
と 、 博士 の 頭 を 巻く て いる た あやかし が 動く 始める 、 髪の毛 の 中 から ずんぐり と 太い 菱形 の 頭 を 持つ た 忌まわしい 蛇 が 、 ぬっと 鎌首 を もたげる た だ は ない か	と、博士の頭を巻いていたあやかしが動き始め、髪の毛の中からずんぐりと太い菱形の頭を持った忌まわしい蛇が、ぬっと鎌首をもたげたではないか
毒沼蛇	毒沼蛇
シャーロック・ホームズ が 声 を 張る	ホームズが声を張る
インド で もっとも 恐る べし 蛇	インドでもっとも恐るべき蛇
博士 が 噛む れる て 死ぬ まで 、 たった 十 秒 だ	博士が噛まれて死ぬまで、たった十秒だ
暴力 は 我が身 に 返る が 必然	暴力は我が身に返るが必然
策士 は 仕掛ける た 穴 に 自ら はまる	策士は仕掛けた穴に自らはまる
この 毒蛇 を 巣 の 中 へ 追い込む う	この毒蛇を巣の中へ追い込もう
そして ヘレン・ストーナ さん を 安全 だ 場所 へ 移す 、 地元 の 警察 へ 事 の 次第 を 報告 だ	そしてストーナさんを安全な場所へ移し、地元の警察へ事の次第を報告だ
言い終わる や シャーロック・ホームズ は 死人 の 膝 から 素早い 鞭 を とる 、 その 鞭 の 先 の 輪 を 毒蛇 の 首 にかけ 凶行 の 場 から 引き離す と 、 蛇 を 腕 いっぱい に 伸ばす て 運ぶ 、 鉄製 の 金庫 の 中 へ 投げ入れる 閉じこめる た	言い終わるやホームズは死人の膝から素早く鞭をとり、その鞭の先の輪を毒蛇の首にかけ凶行の場から引き離すと、蛇を腕いっぱいに伸ばして運び、鉄製の金庫の中へ投げ入れ閉じこめた
以上 が ストーク・モラン の グリムズビ・ロイロット 博士 の 死 の 真相 だ ある	以上がストーク・モランのグリムズビ・ロイロット博士の死の真相である
ここ まで の 話 が 長い なる た ので 、 その後 の こと は 簡単 に 話す う	ここまでの話が長くなったので、その後のことは簡単に話そう
我々 は ふるえる ご 婦人 に 悲劇 を 告げる 、 早朝 の 汽車 で ハロウ に いる 善良 だ 叔母 の 元 へ 送り届ける た	我々はふるえるご婦人に悲劇を告げ、早朝の汽車でハロウにいる善良な叔母の元へ送り届けた
警察 の 調べ に は 時間 が かかる た が 、 危険 だ ペット の 取り扱い を 誤る た ため の 事故死 と 結論づける られる た	警察の調べには時間がかかったが、危険なペットの取り扱いを誤ったための事故死と結論づけられた
まだ 腑 に 落ちる ない 点 は ある た が 、 シャーロック・ホームズ は 私 に 、 翌日 の 帰り の 車中 で 教える て くれる た	まだ腑に落ちない点はあったが、ホームズは私に、翌日の帰りの車中で教えてくれた
はじめ 僕 は まったく 誤る た 推定 を 下す て いる た	はじめ僕はまったく誤った推定を下していた
不十分 だ データ で 推理 を 行う と 危険 だ という いい 一 例 だ	不十分なデータで推理を行うと危険だといういい一例だ
ロマ が いる た	ロマがいた
ひも という 言葉 を 哀れ だ ご 婦人 が 口走る た	ひもという言葉を哀れなご婦人が口走った
つまり それ は 、 マッチ を 擦る た とき 、 一瞬 何 か の 姿 を 見る た こと を 表す て いる	つまりそれは、マッチを擦ったとき、一瞬何かの姿を見たことを表している
だが それ が かえって 僕 を 誤る た 方向 へ 追いやる た	だがそれがかえって僕を誤った方向へ追いやった
ただ 幸い だ た と 言える の は 、 すぐ 考える 直せる た こと だ	ただ幸いだったと言えるのは、すぐ考え直せたことだ
部屋 に いる 人物 を おびやかす 危険 が 何 だ ある た に する 、 それ は 窓 や 扉 から 入る た もの だ は ない と はっきり する た の だ から	部屋にいる人物をおびやかす危険が何であったにせよ、それは窓や扉から入ったものではないとはっきりしたのだから
前 に も 話す た とおり 、 僕 の 注意 は すぐさま 通風 口 と 寝台 の 上 に 垂れ下がる 綱 と に 向ける られる た	前にも話したとおり、僕の注意はすぐさま通風口と寝台の上に垂れ下がる綱とに向けられた
それ が 飾り だ ある こと 、 寝台 が 床 に 固定 する れる て いる こと を 知る て 、 すぐ に この 綱 は 何 か が 穴 から 寝台 へ 伝う ため の 橋渡し を する て いる の だ は ない か 、 という 考え が 浮かぶ だ	それが飾りであること、寝台が床に固定されていることを知って、すぐにこの綱は何かが穴から寝台へ伝うための橋渡しをしているのではないか、という考えが浮かんだ
蛇 の 姿 が さっと 頭 に よぎる	蛇の姿がさっと頭によぎる
博士 が インド から 動物 を 取り寄せる て いる こと を 考える 合わせる と 、 信憑 性 が 出る て くる	博士がインドから動物を取り寄せていることを考え合わせると、信憑性が出てくる
毒物 に も 、 どんな 試験 で も 検出 する れる ない もの が ある	毒物にも、どんな試験でも検出されないものがある
それ を 使う と は 、 さすが 東方 で 仕事 を する た 男 の 悪知恵 と 言う べし か	それを使うとは、さすが東方で仕事をした男の悪知恵と言うべきか
しかも この 毒 に は 即効 性 が ある 、 この 点 だ も 都合 が いい	しかもこの毒には即効性があり、この点でも都合がいい
毒牙 の 食い込む だ ところ に は 、 ごく 小さな 黒い 傷 が ふたつ 残る だけ だ から 、 目 の 利く 検視 官 だ ない かぎり 見逃す て 当然 だ	毒牙の食い込んだところには、ごく小さな黒い傷がふたつ残るだけだから、目の利く検視官でないかぎり見逃して当然だ
それから あの 口笛 の こと だ	それからあの口笛のことだ
無論 、 朝 に なる て 相手 に ばれる て は いける ない から 、 博士 は 蛇 を 呼び戻す ぬ ば なる ぬ	無論、朝になって相手にばれてはいけないから、博士は蛇を呼び戻さねばならぬ
そこで 訓練 を する た	そこで訓練をした
あの 牛乳 でも 使う た の か 、 呼ぶ ば 戻る よう に する た わけ だ	あの牛乳でも使ったのか、呼べば戻るようにしたわけだ
頃合 い を 見計らう て 毒蛇 を あの 通風 口 へ 向かう せる 、 蛇 は 綱 を 伝う 寝台 へ 下りる	頃合いを見計らって毒蛇をあの通風口へ向かわせ、蛇は綱を伝い寝台へ下りる
一 度 で 噛む と は 限る ぬ から 、 一 週間 の あいだ は 毎晩 うまい 避ける られる た の だ う が 、 遅い 早い 、 その 犠牲 と なる に 違い ない	一度で噛むとは限らぬから、一週間のあいだは毎晩うまく避けられたのだろうが、遅かれ早かれ、その犠牲となるに違いない
ここ まで の 結論 に は 、 博士 の 部屋 へ 入る 前 に たどり着く て いる た	ここまでの結論には、博士の部屋へ入る前にたどり着いていた
椅子 を 調べる と 、 上 に 博士 が しばしば 上がる て いる こと が 分かる た	椅子を調べると、上に博士がしばしば上がっていることが分かった
もちろん 通風 口 に 手 を 届く せる ため に 必要 だ	もちろん通風口に手を届かせるために必要だ
金庫 、 牛乳 の 皿 、 先 を 輪 に 結ぶ で ある 鞭 、 これら を 見る ば 、 もはや 少し の 疑問 を 残す ところ も ない	金庫、牛乳の皿、先を輪に結んである鞭、これらを見れば、もはや少しの疑問を残すところもない
ヘレン・ストーナ さん の 聞く た 金属 音 は 、 博士 が 怪物 を 戻す て 大急ぎ で 金庫 の 戸 を 閉める た 音 に 相違 ない	ストーナさんの聞いた金属音は、博士が怪物を戻して大急ぎで金庫の戸を閉めた音に相違ない
この よう に 考え を 煮詰める た 上 で 、 証拠 を 握る う と あの 通り 行動 に 移る た わけ だ	このように考えを煮詰めた上で、証拠を握ろうとあの通り行動に移ったわけだ
僕 は 、 しゅっ しゅっ と あの 生き物 が 音 を 立てる た の を 聞く て —— 君 も 聞く た ね —— そこ で さっと マッチ を 擦る て 、 一 発 食らわせる た	僕は、しゅっしゅっとあの生き物が音を立てたのを聞いて——君も聞いたね——そこでさっとマッチを擦って、一発食らわせた
その 結果 、 蛇 は 通風 口 へ 逃げ失せる た	その結果、蛇は通風口へ逃げ失せた
さらに 、 反対 側 の 飼い主 へ と 向かう 結果 と なる た	さらに、反対側の飼い主へと向かう結果となった
僕 が 杖 で 数 発 痛めつける た から 、 引き返す ながら 本性 を むき出し に する て 、 目 に とまる た 最初 の 人間 に かみつく た	僕が杖で数発痛めつけたから、引き返しながら本性をむき出しにして、目にとまった最初の人間にかみついた
だから 僕 は 博士 の 死 に 間接 の 責任 が ある と 言える が 、 さりとて 、 大した 良心 の 呵責 を 感じる そう に ない	だから僕は博士の死に間接の責任があると言えるが、さりとて、大した良心の呵責を感じそうにない
